à	á
faim	zà
mûr	vɔ
mûr	tìg
noix	de
or	gôl1
ais	pìb
pot	mbə
rire	wɛ
sol	sí1
sœur	mɔ
ail	lây1
ainsi	na
alors	hɔ
ami	mbóy
camp	yád
chez	ábɔ
côte	kòn
deux	-bǎ
déjà	àyǎ
dos	mbúz
dose	dóz
fer	ì-cè
fève	mbɔ
gant	gáŋ
laver	sò
ma	-am̋à
mal	kwàn
mal	bɔǵ
maman	nà
matin	cə
mer	m-áŋ
même	sêm
mère	ɲɔ
non	àyâá
poule	kú
oux	mázâ
puer	nùm
atre	-nà
	m̀-pyáŋ
sexe	zùd
endu	bô
terre	cà
on	ì-tón
tout	-sə
tuer	wéy
un	-mwág
un	pwág
vomir	jó
aide	ì-kà
aider	kà1
aigu	vól
amer	jòl
atom	tɔm̌
ahi	pòdbò
banc	báŋ1
base	tín1
bière	byâ
bêler	tàd
bleu	ɲól2
boa	mbɔm̀
boire	ɲúŋ
bon	ɲəb̀
brin	kɔŋ́
bœuf	ɲàg
bœuf	kág1
arter	bó2
chien	mbú
ciel	d-ǒb
citer	túd
clan	éton
lore	kpá
cola	gòdò
comme	ànə
cri	ǹ-tàd
cri	pɛď
cri	káálá
cru	nùmní
deux	bàà
Dieu	zàmá
donc	vɔ3́
face	à-sú
faire	kòm
famine	zà
finir	màn
flanc	mbà
forger	lú
fort	ŋgùl
fufu	vùvú
fuir	tú1
fuir	sɔ3́
fumet	zǐŋ
gagner	dɔ
gare	bán1
germer	jò
guib	són
haïr	síŋ1
haut	jàb
homme	pâm
huit	ŋmàm
intrus	kɔ
jeu	ì-vǒy
jeu	à-byà
jonc	kwǎl
jouer	càb
kilo	kílâ
jouir	càb
kola	gòdò
laid	à-bé
laid	ɲěy
ever	nálâ
lever	sám
liste	líz
litre	líd
long	jàb
lèpre	zǎm
mal	faire
mal	ù-bà
manger	dí
	mìŋkə́ŋə
maïs	mbàz
mes	-am̋à
miel	w-ěy
mon	-am̋à
mouler	mə
mûr	ɲ́câ
net	kpáám
nez	d-ǒy2
nid	d-ùmá
nom	d-ǒy1
nos	-èèní
nu	ɲ̀-cɔ
nu	ǹ-nəŋ́
nul	zəz̀è
okra	pɛž
os	ì-vɛž
passé	màn
perdre	dá
porc	ŋgǒy
pépin	mbɔ
père	íꜜsá
prune	sá1
rat	sálâ
rien	háb1
rite	bíná
robe	kàbà
robe	kàbà
safou	sá1
sel	ŋ̀-kǔ
pùŋ	sósô
suie	pìdà
sœur	kál1
aler	ɲɛd̀
Tchad	cád
kàdì	síl
tic	púúlá
irer	hɛd́
trois	-lá
tôt	kún1
téter	ɲáŋ
type	kán
vache	ɲàg
venir	zù
vert	ɲól2
vie	ì-nìŋ
vivre	nìŋ
voler	jíb
w.c	ì-dúg
vos	-èèní
vrai	ɲǎ2
aboyer	bón
accord	cíŋ
acide	ŋmám
aimer	dìŋ2
aller	kə3̀
amuser	càb
aîné	ǹ-tól
arbre	ì-lə
wóódè	pǒn
arche	árkâ
assez	ndúŋ
avare	àkàb
bander	vàŋ
barbe	zɛl̀
bien	ɲəb̀
blanc	pùm
bénir	bàbì
bois	ŋgàlà
bois	kóŋô
bondir	józ
bras	ì-nàm
brio	nəg̀
bruine	pòb
bâton	kóŋô
buffle	ɲád
but	ì-kɛǹ
cadeau	dáz
cadet	mbúz
caprin	só
casser	bó1
centre	zǎŋ
cerveau	bɔ
chanter	jà
chaque	-sə
chose	d-àm
cinq	-tán1
citron	mǎŋ
lat	ì-pɛź
lore	kəǵ2
cor	ì-bágî
orce	ì-bàb
orcher	póz
corps	ɲól1
coton	sùd
couper	cíg
crabe	kádá
raser	kɔg̀
croître	jò
cuire	bə1́
cuire	bùm
de	nouveau
dense	ndìm
dire	cɛd̀ì
dix	ɛ-̀wóm
don	ì-págâ
don	ì-yóm
dépecer	bà
droit	ŋmìz
dur	à-lɛď
durer	káb4
efok	ì-pòg
empiler	jɔ
enfler	vúz
entier	-sə
entrer	ɲíì
faché	pàm
faible	kúl
faner	sà2
ferme	mbóm
fermer	dìb
fesses	zùd
feu	kòmnò
fibre	kɔŋ́
fleur	sǎm
force	pím
force	ŋgùl
fou	ɛ-̀kúd
pàŋnâ	sá1
fumée	vídâ
fumer	dùd1
fusil	ŋgál
gage	ì-bán
arere	dáŋ
genre	kán
graine	mbɔ
guérir	já2
habit	ì-jə
herbe	sáz
herbe	àpàd
hier	ŋgògí
huer	ɲùmnì
humble	kúl
jeter	g͡bà
iule	ŋgɔy̌
jour	à-lú1
jupon	sìmá
jurer	kànì
kola	ɲɛl̀
landa	lànà
latte	lád1
lécher	ɲây
lent	à-tǔ
lever	vàzà
liane	kwǎl
libre	pìlí
lit	ì-nɔŋ̌
loi	mbɛńí
loin	ù-jǎb
louer	lùgà
lourd	dìd
lèvre	ì-já
magie	byàŋ
maigre	líg
maison	ndá
məz̀əg̀ə	̀
maïs	bəb̀ə
mentir	bád
messe	cwáz
midi	tólbé
milieu	zǎŋ
moche	à-bé
oussé	tùl
mûr	ì-vɔ2̀
mère	màŋá
mûrir	təg̀
mur	m̀-pìm
nager	jwág
nervure	kɔ
neuf	ìbùù
noir	à-vín
normal	páŋ
orme	màmà
nu	ndógdó
odeur	d-ěy
ongle	j-ǎ2
ordre	tág
ouvert	pɔ
palme	mbí
andre	ɲɛd̀
pari	ì-bán
aule	ì-túl
peau	ì-kòb
percer	tú2
pet	ɲ̀-cùl
peur	sìzà
pièce	kábâ
piler	cág1
ine	ì-jɔy̌
pli	ì-ɲəǵ
plier	bág2
plier	kúd
plume	tám1
poil	ŋgàz
onge	ɛ-̀ɲà
onge	kùzá
oque	ɲ̀-ɲə
pourrir	bɔ
pousser	jò
père	tàdá
père	íꜜsɔ
priver	cì
prêt	bəb̀ə
pâte	ì-bǐg
pétrir	bìg
puce	ì-dàŋ
uisé	làbàg
puiser	bòd
and?	ídɛń
race	mbɔŋ̀
pus	ɛ-̀víl
eue	ù-làn
inine	kíní
rancir	sùn
raphia	zàm
raser	kəŋ̀
rat	mbɛń
rat	ì-kwě
rater	cɔǵ
ride	ù-tàd
rive	cíngí
riz	ù-lɛź
rouge	à-və
safou	àpǔm
sauver	nì
sauver	nì
scier	sìg3
sein	ɛ-̀bé
serré	kág2
siège	ì-tɔ
signer	sán
singe	kwé1
pùŋ	ù-sǒg
soleil	ǹnó
tacle	cáz2
tailler	bà
tante	sáŋá
taon	ù-sún
taper	bímî
tendre	bùd
kàdì	kwád
kàdì	káb1
terre	sí1
thon	tɔŋ́3
tique	kób2
iré	ɲ̀-còg
tirer	dùd1
irer	ndàmì
tisser	tìŋ
tissu	sàzà
toit	ǹ-nwǐ
très	à-bwǐ
venir	sɔ2́
verre	ì-lá
veste	kód1
vieux	ǹ-tù
vin	bì-lám
violer	tàn
vipère	péy
vivant	və
vol	g͡bəb́
ondo	kɔĺɔ
abattre	kpə
abcès	d-wǎd
abondant	pò
accuser	bád
acheter	kùz
acte	ì-táz
aigre	sàŋ2
aile	ɛ-̀pǎb
aimer	dìŋnì
aisance	mbá
alcool	hàà
aller	kə1̀
amour	pwàd
ananas	zəg̀
année	m̀-mú
anus	ì-láŋ1
appât	ɛ-̀dí
arbre	à-sá
wóódè	tɔm̌
wóódè	tɔľ
wóódè	ǹ-tɔ
associé	àsò
battre	bímî
bêcher	səŋ̀
berge	cíngí
bien	mbwàgí
ène	məv̀ínâ
bénir	kàb2
boire	ɲúŋâ
bon	ɛ-̀bəŋ̀
boue	mbàdgì
boulou	búlî
bourrer	jɔ
bourrer	bóg
bouton	lógô
brûler	díg
caca	mə-̀bí
bru	m̀-mɔḿ
bruit	ì-dǔŋ
bâton	ù-sɔ
aille	ì-báz
cailler	wól
canne	ǹ-túm
casser	búgî
cécité	ndím
cesser	vwàd
champ	à-púb
chaîne	cɛń
happer	tú1
chat	ì-síŋâ
chaud	bàmlà
chemin	zɛň
heveau	kùzá
chose	j-ǒm
chuter	vázî
clé	ì-dììgà
cochon	ŋgǒy
coin	kwánâ
ole	zək̀úlî
coller	bàgì
colobe	sósô
combien	-áŋ
comment?	yá
orce	ì-vín
orché	sódô
coûteux	dyâ
coton	ndəb̀
couper	kpə
couper	bázî
courber	vìd
courir	tə1́
court	hɛd́
outer	vóglô
crachin	pòb
raser	píd1
crasse	mbìd
cri	ù-lɔŋ́
croire	kàŋ2
croître	tù
crépir	síŋ2
cuire	bɛĺə
cuisse	à-bə
ume	ì-vúvûz
cœur	ǹ-nəḿ
ureuil	mbǒg
d'abord	tá
demain	kídí
depuis	kɔḿ
diluer	sòlò
dénoncer	bó
dormir	jázî
dot	ì-vəg̀ə
désir	kpámâ
ekang	ì-kǎŋ
emien	à-kùg
enterrer	dè
envie	kpámâ
envoyer	lóm
etoup	ì-tùb
exposer	les
expres	váŋ
exulter	pòn
farce	ì-làŋ
festin	dínâ
filet	mbúná
fièvre	píbâ
flamber	bwî
fleurir	kpá
foie	ì-səǵ
fond	ì-bón
fond	ɛ-̀tǐg
fonder	bònì
fondre	ɲámâ
forge	à-lú2
fort	mbəm̀
fosse	ì-díb
fourmi	kám1
frais	vɔ2́
frôler	nàmà
frotter	sí2
fête	ɛ-̀bóg
fêter	jəḿî
fumer	túgâ
glacé	dàbgì
globe	ɲ̀-cɔ
gémir	méénì
goal	ì-kɛǹ
gonfler	vúz
gorille	ɲjì
oïste	kpàg2
grade	ì-kúg
grand	nɛń
grandir	náŋ
grâce	mbɔm̌
griller	bùm
gros	ì-ndód
grossir	pàg
hache	ù-vón
heurter	jìm
hotte	ŋ̀-kɔ
houe	ì-kwàb
initié	mbón
jaune	ì-súg
jeter	cáŋdâ
joue	ɛ-̀máŋ
jour	à-mǒz
jusque	vwàz
lancer	g͡bà
larve	pwáz
lavage	ù-sò
layon	ǹ-nán
lent	à-tɔŋ́
lent	ndəŋ̀2
lettre	d-ǐz
lever	kódô1
ever	nɛńî
liane	à-lùm
livrer	nəm̀
long	ì-bàn
long	kúdâ1
lourd	à-dǐd
éphant	zɔg̀
lézard	ɲ́cɔ
malaxer	bù
manger	víb
manger	həb́
marc	ŋ̀-ŋám
marmite	mbə
masser	wúd
masser	báb2
membre	ì-dò
messe	mɛź
mettre	pùdì
mieux	bɛd́ə
moabi	à-jàb
moisir	lùzà
monter	jàm
monter	bɛd́
montrer	les
mou	ì-bùbùd
moudre	kɔg̀
oussé	à-tǔl
mûr	ɲ̀-cùd
mûr	ŋ̀-kúz2
muet	m̀-múg
nain	ì-núŋá
nasse	ɛ-̀jà
naître	wálî
mutité	mbúg
mygale	ŋgám
notre	-èèní
nouvelle	pɔ
odeur	ì-nǔm
offrir	dázâ
oiseau	àmàn
padouk	bázâ
pagne	ì-kòb
orphelin	mɔ
otage	ì-bán
ouate	ndəb̀
ouvrir	kpá
pain	ì-tùb
ais	ǹ-tìgní
panier	j-ǎd
anoui	mbóm
paquet	d-ǒm
argne	ù-lìŋ
argner	kɔỳ
payer	yágnà
pêche	à-lóg
pêcher	jɔb́
peau	ì-vùl
pendant	átá
percer	twî
perdre	dáŋ
perdu	làmbà
peur	w-ɔŋ̌
peur	ì-sìzà
photo	pódô1
icicé	ì-jǎŋ
piéger	lám2
pipe	ɛ-̀bùg
piquer	dígâ
pitié	ŋgwál
plaisir	mbá
plat	ɲ̀-ɲám
plat	ì-cágâ
plat	sàŋlà1
pleur	ǹ-tàd
plomb	àpídâ
plonger	láb
lucher	pózî
lucher	kpàm
pluie	mbəŋ̀
plutôt	ndúŋ
poil	ɛ-̀vùl
porter	dál
poser	bɛd̀ì
pot	ù-dɔg̀
pot	kúlwàdá
poudre	bázâ
ouse	ŋ̀-ŋál
poyane	zòl
prêtre	pàdà
puits	ì-tàm
pulpe	ì-súg
itte	bìkpéy
itter	kódô1
rack	ù-jəŋ̀
racler	wɔḿ
radin	ù-kág
radio	ràdyô
ranger	bág2
raphia	sàzà
rat	ì-bɔg̀2
récit	ndɔŋ́
rein	ɛ-̀tám
reins	ù-dúg
remuer	pógó
risée	bì-jǎ
rixe	ì-tɔm̀
réjouir	pòn
roche	ì-kóg
ronger	wòdì
rosée	ì-búâ
sac	m̀-pəǵ
rôti	kááŋgá
ruiné	ì-kùn
rythme	ság1
sac	ŋ̀-kùd
saisir	g͡bè
saleté	mbìd
saluer	kónî
Sanaga	jɔm̌
sang	mə-̀cǐ
sauver	kòdì
savoir	njí
savon	sɔb́ɔ
séduire	kàz
seau	ǹ-nòŋó
sept	zàŋmál
singe	cígdî
six	sàmnì2
six	-sàmnì1
soif	ì-kódí
songo	sɔŋ̀ɔ
souris	ì-dù
sésame	ɲádâ
suivre	tòŋ
suivre	tó2
suivre	cág2
sève	ɛ-̀cíl
tacler	cáz4
agère	ì-tág
tas	ɛ-̀ŋgóz
tasse	kɔb́1
kàdì	sómló
kàdì	kwàd1
tester	pìzì
tirer	límdâ
tombe	sɔŋ̀2
tomber	páz
tonneau	káz
toucher	kòm
trace	ɛ-̀bɔ
trahir	kəḿ
m̀-mə̀glə	̀
trier	pyàlì
trier	báŋî
triste	à-bé
trouver	dìb
vagin	mbɛľ
vanter	lùgà
uriner	vyé1
usé	ǹ-síbní
usure	cəg̀1
utérus	kòmó
venger	kùn2
vent	ì-vúnî
ver	ɲ̀-cɔŋ́
vide	ì-vóy2
vigueur	pím
visage	à-sú
votre	-èèní
vrai	m̀-pàŋ
achat	ŋ̀-kùz
abstenir	cì
achever	jílâ
adulte	à-mòd
affûter	jəb̀
agressif	hàm
ajouter	bág1
ako	áꜜlɔǵɔ́
alité	ǹ-tɛd́
allonger	sám
amant	ì-bwàn
amont	ɛ-̀kwě
amour	kúngâ
amour	bómnì
apaiser	sùz
appeler	kpàd
appâter	sɛl̀
appuyer	bán2
arbre	ŋgòŋò
arbre	à-kùg
arbre	à-jàb
arbre	à-dǔm
arbre	à-bàŋ2
wóódè	ù-kód
wóódè	pòglò
wóódè	ŋgòn1
wóódè	kɔm̀ɔ
arbuste	à-tù
arc	ì-ŋgàŋlâ
argile	vyǒg
arracher	bàl
arranger	kòm
arrêter	g͡bè
attaché	tyǎ
attirer	dùd1
attiser	sɛl̀
autel	àlàtàr
bafia	bəp̀yà
autre	-pəb́ə
autrui	íꜜzá
avare	ù-kág
avocat	lɔýâ
azobe	ì-kógó
baiser	kúngâ
balayer	vyé2
ballon	ndàmà
bambin	ì-sòm
bande	bándád
banquet	dínâ
baobab	d-úmá
bar	ì-pàtìlá
bassin	bísîn
battre	bímnì
beau	ɛ-̀bəŋ̀
beaucoup	pò
bercer	póblô
bible	bíbɛl̂
biche	ù-bál
blague	ì-làŋ
bloquer	yəḿ
bord	ŋ̀-ŋóm
bord	ŋ̀-kòm
bord	ì-ɲəǵ
bord	ɛ-̀vɛl̀
bouger	ndəŋ́
brise	ì-vúnî
brûler	bàmlà
brosser	wàz1
caché	swàlɔ
cacher	swàlì
cacher	bòmbò
cachet	zìtám
ailler	sógî
capturer	kàm
carpe	mbàgà1
carquois	pàd
causer	láànì
chair	ɲ̀-còn
champ	bì-nà
chance	bəs̀ɔ
chanson	j-ǎ1
chanvre	báŋâ
charbon	d-âg
chasser	sòm
chasser	bó2
chasser	bəŋ̀
helle	ù-lɔŋ̀
cheveux	l-òŋ
chiche	ù-kág
choisir	tɔb́
chétif	ì-kpá
chèvre	kábdì
civette	zɔỳ
clan	ɛ-̀jɔŋ̀
coaguler	wól
cogner	pámî
coiffer	kəŋ̀
coincer	yəḿ
collé	bàgá2
colère	ù-lún
commun	pùlá
orcher	pódô2
corne	ì-làn
costaud	kəm̀
couché	jògó
coula	ì-wómî
couleur	ɲól2
coup	ì-kúdâ
couper	báŋî
couper	cígî
couper	mwàz
couper	kɛd́
couper	bəǵ
court	ì-kùŋá
couvrir	búdî
revisse	sínâ
riture	ù-tìl
crochet	kɔb̀
crotte	ɛ-̀bí
côté	ɛ-̀vɛl̀
cueillir	pád
cuillère	tóg
cuisiner	jám
culotte	háb2
ureuil	ì-kpá
danse	bì-kùd
débuter	tádî
décéder	jíî
déchirer	ɲàb
dent	ɛ-̀sɔŋ̌
dessein	váŋ
dette	ì-kòló
devise	ndán
défricher	lí
défunt	ì-jóŋ
diminuer	sùz
dispute	záŋ
disputer	sùŋ
divin	à-zàmá
donner	kàznì
doué	à-kəŋ́2
doué	kəŋ́bə
douleur	à-yá
déposer	jògì
détacher	tìì
effacer	dímâ
détruire	bó1
uquer	kəŋ́lə
durée	ɛ-̀bǒg
emballer	vàŋ
enduire	píd2
endurer	jíbâ
enfuir	dɔb̀ì
envie	ù-záŋ
espèce	mbɔŋ̀
essuyer	pímî
evoula	ì-vúl
exalter	lùgà
excéder	dàŋ2
expulser	bó2
extraire	bòg
fatigue	sɔḿ
fenêtre	wúnâ
fermé	pɛd̀ə
fermer	pɛd̀
fesse	ɛ-̀kǎn
feuille	ká1
fibre	ndàmdâ
ficeler	kàŋ1
figuier	tɔľ
fille	ì-sìlà
filtrer	bìnì
flèche	ì-lây
fleur	sàmgí
fleur	m̀-móm
fleurir	sàm
flûte	ù-dìŋ
flétrir	sà2
fois	ì-jɔŋ̀1
folon	kùkùmà
forêt	ɛ-̀pàn
fouet	ŋ̀-káz
fougère	zəŋ́
pùmá	ù-kpád
frake	à-kɔm̀
franc	síngì
frappe	ì-kùd
frapper	bímî
frémir	ɲàmnì
froid	dàbgì
fruit	à-bɛĺ
fétiche	byàŋ
gale	ɲ̀-càŋ1
gardien	gôl2
gémir	símnì
goliath	d-ǎz
gombo	ì-nəm̀
goûter	kəg̀ì
goître	ì-vǒg
goutte	ɛ-̀tɔ
grandir	pàg
graver	kpɛd̀
griffer	wòdì
grimper	bɛd́
gâter	ndámnà
gueule	à-nùŋ
guêpe	cìcìlá
guérir	bàbì
hangar	ì-sà2
haricot	kón2
haut	píꜜlɔŋ́
herbe	ì-lɔǵ
herbe	ù-sím
hernie	ù-jóŋ
heure	ɛ-̀bǒg
hibou	ɛ-̀kùŋ
honte	ù-swán
hésiter	sìg1
igname	ì-ɲúm
ignorer	dímâ
l-de	perdrix
hôte	ɲ̀-ɲəŋ́
hutte	ì-bəm̌
importe	zìŋ
injure	ɛ-̀sə
intègre	à-tí
iroko	à-bàŋ2
isolé	ì-təŋ́
jeter	vúmlâ
jeter	səḿî
jeter	pímlâ
jeune	ndɔŋ̀
joie	mì-ntàg
jongler	báz
jupe	ù-bòm1
jurer	màànà
juron	sɔŋ̀1
laisser	jògì
lait	mə-̀ɲáŋ
lame	ɛ-̀njáŋ
large	pòbááŋ
larve	ɛ-̀kǔm
laver	sòbnì
lâche	ɲ̀-còg
lent	tɔŋ́bɔ
lessive	ù-sò
libérer	kòdì
ligne	ǹ-tɛň
liqueur	hàà
oge	ŋ̀-kàŋní
long	píꜜlɔŋ́
long	pɔɔ̀ḿ
loquace	kpál
machette	pà1
lundi	mwánî1
lutte	ɛ-̀sìŋ
lutter	dùbnì
maigrir	bɔŋ́
mamba	ŋ̀-kòd
manquer	cɔǵ
marché	mákíd
marcher	tə1́
mari	ɲ̀-ɲóm1
marigot	ù-só
maïs	ì-kùdà
maudire	jɔg̀
mauvais	à-bé
méchant	à-bé
merde	mə-̀bí
mince	à-bwád
mêlée	ì-tɔm̀
modèle	pàdnà
mone	ɛ-̀sùná
monnaie	cáz1
monnaie	kábâ
moracée	tɔľ
morve	ì-swáz
mouton	kábdì
mûrir	víblá
murmurer	ɲíŋ
natte	ì-kàlì
niais	ì-mbón
nombreux	pò
nommer	bòmlò
occiput	kɔǵ
oiseau	dùgá
ordures	ŋgùn
païen	bə-̀tí
pagayer	dúg2
ouvrir	yázî
ouvrir	kúmdâ
palme	ì-súg
pangolin	káy
panicule	sǎm
pardonner	jù
parier	ì-bán
parler	jəǵî
parole	ɛ-̀vɔ
arpiller	càm
partant	ì-kə
partir	kódô1
passer	kàznì
patience	pǐn
aule	ɛ-̀bán
pécher	səḿ1
peigne	ì-wàz
peigner	wàz1
peindre	pɛń
peine	mì-ntá
perdre	lɔź
perdu	pùdbà
ervier	ù-bàm
petit	cəc̀àd
hémère	ndòn2
piaffer	swán
pierre	ŋgɔg̀
piège	ndɔŋ́ɔ
ilepsie	káná
piment	ù-là
piment	lòbò
pincer	jìdì1
pingre	ù-kág
piquer	sòblò
pirogue	m-ál
placer	bəm̀ì
plainte	mbàŋ
plantain	àlú
plante	ɲɔỳ
plante	àbɔl̀
plein	təm̀bə
pleurer	jə2̀
lucher	tònì
pénétrer	ɲíì
poison	ɲ̀-cù
poisson	kwǎz
police	pùlúz
pondre	tágî2
pot	m̀-mɔŋ̀
poudre	ndwì
poussière	cà
prendre	ɲɔŋ̀
presser	myàd
profit	m̀-pí
profond	pùd
prout	ɲ̀-cùl
préparer	jám
querelle	záŋ
purger	bóónò
python	mbɔm̀
queue	ŋ̀-kǒn
inine	ì-kùg
rancune	ì-bá
rang	ɲ̀-cámá
rapace	káyám
raton	mbəń
récolter	bòg
refouler	bó2
rempli	ǹ-túd
reprocher	jò
reste	ɛ-̀tǐg
rester	lígî
rester	bógbô
retard	mbúz
rivage	cíngí
rivière	ù-só
réjouir	tàg
roche	ù-sán
rocher	ŋgɔg̀
rotin	ǹ-nɔŋ́
rotin	mbəŋ́
rougeur	còd
répandre	càm
résidu	ì-jám
ruine	ì-kùn
rusé	ù-bàŋgí
réveillé	və
révéler	páŋâ
sagesse	pəg̀
sapelli	à-sə
sauter	jɛĺî
sécher	yánî
sentier	zɛň
sentir	nùmlà
serpent	ɲɔy̌
pùŋ	ù-ŋgɛž
slip	ŋ̀-káná
soie	zəŋ̀gà
soigner	pílî
soin	nəŋ̀lə
souche	ì-kǔm
source	ì-tàm
sourire	múŋ
soutenir	súg
succéder	tó2
succès	nəg̀
sucer	sɔb́dɔ
suinter	jólə
surplus	mbùg
table	təb́lə
tante	swáŋɔ
tard	mbúmbúâ
teigne	ɛ-̀kɔ
temps	ɛ-̀bǒg
tendre	lám2
tenter	bóblô
kàdì	pɛĺgí
tige	ɛ-̀tín1
incelle	kâg2
tirer	dùùdà
irer	límdân
tolérer	jíbâ
tomate	tòmád
tortue	kúlâ1
toucan	kúngí
tourner	sùn
tousser	kwáz
toux	ì-kɔźî
trait	ǹ-tɛň
travail	ì-sá
travail	kàmá
tremper	jínî
tresser	pɛǹ
tronc	ŋ̀-kùm
trou	ɛ-̀jɔŋ́
tsétsé	ù-bòg
tunnel	ì-sàm
tuyau	zɔŋ́2
type	ì-bəg̀á
vase	mə-̀lǐb
veine	ɲ̀-cǐz
vendre	kùznì
venger	kùnì
verser	dàbdà
verser	kúbî
verveine	des
ville	tíswân
vin	mə-̀jɔ̀g
viser	kɛd̀nà
vouloir	jə1̀
youyou	káálá
abattu	kùlbà
abîmer	ndámnà
absent	jəḿnì
acidité	à-sǎŋ
actif	ŋ̀-káŋá
aggraver	túlî
agiter	ləǵnì
agoniser	bímî
aiguiser	jəb̀
ailes	ǹ-nəŋ́
albinos	ǹ-nàŋ
alcool	bì-lám
allaiter	ɲáŋâ
allumé	kàblà
allumer	bɔg̀ì
amasser	kóznò
amende	àlàmán
amibiase	bùnì
ample	ɲ̀-còg
amvout	à-mbǔd
ange	íŋgɛĺzì
anémie	mə-̀cǐ
anneau	ù-kɛń
anomalure	ŋgù
appel	ù-kábí
apporter	kə3̀
arbre	ù-zwál
arbre	à-ndòm
arbre	à-mbǔd
arbre	à-lɔm̌
arbre	à-kɔm̀
arbre	ì-sánî2
wóódè	ù-vəŋ̀
wóódè	ù-pɛź
wóódè	m̀-pǒl
argent	síngì
argile	ì-kwán
arracher	làlì
arrivant	ǹ-sɔ
assiette	ì-só
asthme	ì-bǎb2
asticot	ì-túm
athérure	ŋgǒm
attaché	tììbà
attacher	kàŋ1
attraper	g͡bè
augure	ɛ-̀bə
avaler	sógdô
avare	pɔm̀nì
avertir	bəḿî
avidité	ndɔg̀
bain	d-ɔǵbɔ̂
balai	ì-vyɔĝ
bambou	ì-bà2
barbe	zəŋ̀gà
barrière	sàzà
bassin	ù-dúg
bateau	tìtímâ
bave	ɛ-̀kəŋ̀1
beaucoup	lógó
bien-être	mbá
bâiller	yáànì
billet	tíkɛd̂
blanc	ǹ-táŋní
bénir	púúbân
boiter	cəḿgə
bonheur	bəs̀ɔ
bonsoir	ŋgògí
bosse	ì-ŋgúl
bouger	sílâ1
bouillir	twàg
bravade	à-nùŋ
brave	ŋ̀-káŋá
braver	nəǵnì
briller	kàblà
briquet	brìké
brûler	bɔg̀ì
brûlure	ì-jǎŋ
brouter	wòdì
bruit	ì-sòg1
brun	ì-vɛĺî
bâton	sògzò1
bâton	ì-ŋgəŋ́
bâton	ndəŋ̀1
cadeau	ì-págâ
café	ì-pàtìlá
cafard	pəṕéy
cahute	ì-bəm̌
caisse	ì-zímí
carabine	cábâ
carpe	ndɔǹɔ
casque	ì-kóŋó
casserole	mbə
caverne	ŋgɔg̀
cendre	ɛ-̀swǐ
chaleur	à-jóŋ
hanger	ɲúŋnì
chant	ɛ-̀mbòŋ
chapeau	ǹ-tóm
happer	sɛl̀gə
charbon	m-âg
charger	bɛd̀ì
chasse	ɲ̀-cǒm
hasses	bì-nág
chasseur	m-òd
chemise	swád1
chercher	jəŋ́
chique	ɛ-̀zwě
houer	kpəz̀ə
chérir	məŋ̀lə
ciseaux	ɲjɔỳ
clamer	bəǵlə
clameur	kɔm̀1
clôture	ŋgólô
coccyx	ì-kɔǵ
coiffer	pɛǹ
colique	kòglô
colis	ɛ-̀tóm2
collecter	cáb
commander	jôy
composer	tə2́
conduire	dùd2
confier	jìdì2
orce	ŋ́kɛńə̂
cotonnier	sùd
coucher	bóŋbô
couler	còbdò
couper	sɛd́î
couper	lɛźî
couper	kpàgì
courge	síŋlâ1
couscous	vùvú
céphalope	só
crachat	ɛ-̀té
crainte	w-ɔŋ̌
raser	síŋlâ2
créateur	ǹ-tə
cravate	kwálɔ
crayon	ŋ̀-kòz
crise	ɛ-̀jəb́
créole	ɲjɔb́î
cruauté	à-jòl
côté	kəŋ́ꜜnə
cuisine	kásîn
ureuil	mɔŋ̂ɔ
cuvette	bísîn
daman	ɲ̀-ɲǒg
danse	ì-sánî1
danse	ì-wɔŋ̀ɔ
débrousser	lí
déclarer	vɔ1́
debout	tɛĺə
demander	bólô
derrière	mbúz
descendre	sùz
devenir	mógô
devenir	bógbô
défendre	cìlà
défoncer	vùŋ
dégager	kpàgì
dégoûtant	ɲěy
diarrhée	ńtwí
disperser	sàz
dispute	ì-sùŋ
délabré	ì-túg
dénoncer	kəḿ
dépasser	káŋâ
dépecer	kpàl
déposer	nàlì
désherber	bàl
désordre	sàz
détacher	sógî
détacher	kòzì
effrayer	sìzà
empêcher	jəg̀
encore	bágbá
mbɛǹbə	zòmò
enfant	ì-sòm
enfoui	pùdbà
enlever	vàzà
enlever	swádí
enlever	báŋî
enlever	bázî
enrichir	bíg
enrouler	vàŋ
enrouler	bɔǵ
entrer	ɲíŋlâ
escalader	kà2
escargot	kwé2
essayer	pìzì
estomac	ù-sàŋ
exagérer	dàŋ1
examen	ŋ̀-kàd
exhiber	cɔǹì
fabriquer	kòm
fabriquer	mə
facile	ì-bùbû
fagot	m̀-mɔm̀
exposer	pònì
exprès	ù-váŋ
façon	ɛ-̀kɔm̀
femme	m-ìnŋgá
fente	ì-sàlgà
feuille	ù-ká
fleur	pùláwô
fleur	ì-sàmgà
fleur	ù-zǒm1
former	kəŋ́lə
fouet	ŋmg͡báz
fouiller	cáz3
foulard	ǹ-tóm
franc	d-ɔĺɔ̂
franchir	kpám
frapper	kùmdà
friture	káŋgá
froid	ɛ-̀vəb́
frère	mɔꜜ̌jáŋ
galago	ɲ̀-cá2
géant	píꜜlɔŋ́
genou	ɛ-̀bɔŋ́
genre	ì-bəg̀á
gerçure	kəg̀ə
glisser	sɛǹə
glouton	kpàg2
gonflé	bì-vùg
goûter	dəm̀lə
gourdin	kəǵ1
grand	pɔɔ̀ḿ
gratter	yàgì
grêle	ɛ-̀tâg2
groupe	ì-sámá
habiller	dálâ
gâter	ndámnì
Guinée	ndóŋ1
guêpe	ɛ-̀pǒm
habiller	dál
habitudes	tùm
haine	ì-pəm̀ə
haleter	dàgbà
hameau	à-bàŋ1
hampe	ŋ̀-kɛǹ
hareng	ì-pàgà
haut	ù-ŋgɔŋ̀
herbe	ɲ́câmà
herbe	ì-yámî
heurter	kòbì
hocheur	mbínâ
huile	m̀-mwán
inciser	kpɛd̀
inhaler	swàn
insecte	mbàgà
insomnie	ì-və
insulte	ɛ-̀sə
interdire	cì
intérêt	m̀-pí
jardin	ŋgádnà
inventer	tə2́
inviter	báŋdâ
junior	m-ɔŋ̀ɔ
jupe	ì-sə̀gzə
labourer	ɲùgì
lamenter	jə2̀
lampe	ɛ-̀lámâ
ancé	ŋ̀-kə́mə
lancer	pímlâ
lapin	àlàpágá
largeur	ndàz
largeur	ndàm1
larme	ì-bəǵî
lentement	tù
lessivé	cágdá
long	ǹ-tɔŋ́2
long	kɔm̀kɔm̀
louper	cɔb́dɔ
lutter	lúmnì
lutter	bàdnì
mamba	ɛ-̀jáŋ
mangue	ndɔǵɔ
manioc	m̀-mùŋ
manioc	kpəm̀
mariage	ɛ-̀bá
maudire	ŋgəḿ
meliacée	à-sə
melon	ɛ-̀bɔǧ
message	ndwà
mesurette	dóz
mets	ŋ̀-kóngí
mince	bwádbɔ
miroir	ì-yɛń
modeler	míŋlá
montrer	pònì
moquer	dɔg̀lɔ
mordre	kòglò1
mouche	ǹ-nɔy̌
oussé	m̀-pím
moustac	ù-sǒg
nandinie	mbày
nasse	ɲ̀-cǎl
myriade	àkúdâ
ndole	ɛ-̀tɛd́
nettoyer	púbâ
nettoyer	kùl
noble	m̀-mɛń
noisette	kómî
nom	mə-̀tàmná
nombril	d-ɔb̌
non-mûr	ndǎn
orme	kɔm̀kɔm̀
oiseau	ù-nwǎn
oiseau	káyám
organiser	kòm
orphelin	ɲwǐ
oublier	vúúnà
ourlet	ì-ɲəǵ
palabre	ɛ-̀vɔ
palisser	tónô
panache	nəg̀
anoui	ì-làz2
panser	ləŋ̀2
partager	kàb1
paître	ì-lwág
pencher	nìgbà
pendre	kɛl̀bə
percée	túbnà
personne	m-òd
petit	tɔǵbɔ
pièce	d-ɔĺɔ̂
pied	ɛ-̀tín1
piège	ì-ŋgùlí
pigeon	ù-bəŋ̌
pilosité	ŋgàz
pimenté	ì-jǎŋ
pipe	ŋmg͡bìg
piquant	ì-jǎŋ
pirogue	w-ǎl
planche	kàlà
plant	ɛ-̀tín1
planté	bəm̀ə
plante	ì-sòŋ
plante	ì-sǎŋ
planter	ì-bə
pleuvoir	nɔŋ́
lucher	kpàmì
pénis	ɲ̀-cwád
porter	bəg̀lə
position	ì-tə
posséder	hàdá
poteau	ɛ-̀ndə
potelé	ì-ndód
potto	ɛẃúnî
poudre	m̀-pùŋ
pourri	ì-bwǎl
poutre	m̀-póm
pouvoir	ì-jôy
prise	kùlbá1
prison	m̀-mòg
profond	ndìm
prononcer	túd
pâte	ì-nɔd̀ɔ
pétrir	bùùlà
publier	bɛńî
uisé	ǹ-tàbgì
uisement	sɔḿ
puissance	pím
racine	ŋ̀-kǎŋ
raconter	kànì
raide	ndòndòŋ
ramasser	twáb
rameau	ɲ̀-cá1
ramollir	bwî
ramper	dùùdàn
ramper	dùùdàn
rapace	ù-bàm
raphia	səg̀ə
rare	jəŋ́bân
réclamer	jàgì
récolter	kɔ2́
rebondir	báŋ2
recueillir	kɔ
refaire	bágbá
remplir	jáálâ
rendre	dúgnà2
renommé	wúm2
rentrer	dúgnì
ressembler	vú
reste	ì-kàgá
retard	díŋdíŋ
retard	ì-bóg
retenir	hàdá
revenir	dúgnì
réfléchir	còg
régime	ɲ̀-cág
ricocher	báŋ2
rituel	ɛ-̀kúz
réjouir	sàmà
rosaire	sádyâ
roselle	ì-sǎŋ
rot	ŋmg͡bəg̀1
roulade	kúlâ2
râpeur	ù-jəŋ̀
répéter	báglâ
réserver	kɔỳ
résister	káb4
s'abstenir	cì
saison	à-káb
saison	ù-jòn
saluer	kóònì
sauter	jɛĺî
savane	ǹ-nɔŋ̌
savoir	ù-jəm̀
séché	m̀-mól
scorpion	kádá
secouer	sàmzà
selles	mə-̀bí
semence	púní
simulie	ù-bǐg
soigner	yáŋ2
soigner	jàlì
sorte	ì-bəg̀á
sottise	zəz̀è
souffrir	jùgì
soulever	tə1́
soupe	m̀-pyáŋ
souple	səǵ2
souris	mbəń
souvent	dìŋ1
sperme	ndəm̌
s'étirer	hɛd́
supplier	jàgì
sœur	mɔꜜ̌jáŋ
sœur	mɔꜜ̌ɲáŋ
tache	ɛ-̀twán
tamis	ì-kùdgà
tarder	dɛǹbə
tenir	ndágbâ
tenue	m̀-mwád
termite	ndòn1
termite	by-àm
ernuer	səḿlə
terrible	d-àm
tibia	ŋgɔŋ́lɔ
tôle	ì-kpə́mí
toit	ɛ-̀ŋgàg
toko	ɛ-̀wóngí
tombeau	sɔŋ̀2
tordu	ŋ̀-kwád
toucher	nàmà
toujours	kɔḿ
touraco	ì-kpá
traverser	dà
triste	kùlbà
roit	ù-ŋgɔŋ̀
roit	pídgân3
trouver	sɔm̀
têtu	ndwágbɔ
tuteur	ǹ-tónô
unique	m̀-máŋ
vanité	ì-dɛň
vantard	ù-lùm
utilité	m̀-pí
variété	mbɔŋ̀
vase	kúlwàdá
ventre	ɛ-̀bùm
ver	ɲ̀-ɲìlìg
veuve	ŋ̀-kúz1
village	d-àŋ
viser	ləŋ̀nə
voracité	həb́
Yaoundé	ŋgəb́
vérifier	cáz3
véritable	ɲǎ2
vétuste	ì-túg
vute	bə-̀búdî
abandonner	líg
accord	ù-jílá
accoupler	jàm
administrer	lɔ
adosser	sɛńî
adulation	mbòl
affirmer	vɔ1́
affirmer	tɔŋ́2
affronter	bàl
agacer	ndəǵlə
agile	ǹ-tàndàŋ
agréable	ɲəb̀
agrandir	nɛńə
ajouter	bágnì
allumé	kòòbàn
allumer	kàznà
amertume	à-jǒl
amitié	ɛ-̀mbwé
annoncer	bɛńî
appliquer	kwág
arachide	òwònò
arbre	à-ŋgɔŋ̀
arbre	à-ŋgəg̀
arbre	à-kòngò
arbre	à-kəŋ́1
arbre	ì-siŋgàn
wóódè	m̀-mɛl̀
wóódè	məv̀ínâ
wóódè	ì-yəḿ2
argent	d-ɔĺɔ̂
armature	ì-kpà
armature	pàlì
armoire	kwábdɔ
attache	ŋgàdgì
attendre	yàŋà
aulacode	mbəb́
auvent	ɛ-̀ŋgàg
avantage	m̀-pí
avare	bì-jə́m
avarice	à-pɔm̀
bagarre	ì-tɔm̀
baguette	ì-bà2
balancer	ndəŋ́
barrière	ŋgólô
bassin	ì-tɔǧ
bavarder	kómnó
bébé	ì-bəb̀wàg
beaucoup	bùlà1
bifurquer	bágî
blesser	sàŋnì
blindage	ɲjàmà
blinder	jómlô
blottir	ládbâ
bénéfice	m̀-pí
boiter	pɛńgə
bon	ŋ̀-ŋə́mdə
bosquet	ù-kǎŋ
boucher	ɲ̀-cîg
boudeur	búnbâ
bouture	ì-jwàg
boyaux	ɛ-̀swád
branche	ǹ-təm̀
bravade	ù-lág
brûlé	ì-dídîgà
brousse	ɛ-̀pàn
cabrer	búlgân
bruit	mə-̀tòg
bus	kɔm̀kɔ̀mɔ
cachette	ɛ-̀sɔ
cadavre	m̀-mìm
cahoter	ɲànbàn
cajoler	məŋ̀lə
calebasse	cəǧ
calvitie	ɛ-̀vá
camarade	à-vùz
canard	ù-lwǎd
canard	ì-lɔl̀ì
canari	m̀-mɔŋ̀
capiteux	g͡bè
caractère	d-ǐz
cassé	ì-búbûgà
cerceau	ì-jǎm
hanger	pwàznì
chapelet	sádyâ
charge	mbəg̀lə
charger	sɔŋ̀3
chasse	ɲ̀-cán
chasser	ì-càm
chenille	à-jòz
cheval	ì-kàblí
chevelure	l-òŋ
chicotte	ù-sɔ
cigale	ì-láŋ2
clair	ì-vɛĺî
célébrer	jəḿî
célébrer	kàb2
clitoris	ù-sòd
cochon	ì-ŋgág
coin	ɛ-̀ndúmgí
cola	ŋm̀-ŋmà1
colline	ŋ̀-kǒl
commencer	kázî
concession	yád
confluence	d-ɔ
connaître	jəm̀
conspuer	hàmnì
construire	làŋ
contrôler	cáz3
costaud	g͡bəḿ
coucher	nàŋdà
coucher	jògbò
coude	ì-bwágzí
courage	à-zòmò
courber	kúlbâ
couronne	ì-kád
crapaud	jɔǹgí
crédule	ì-mbón
criquet	àŋgàdà
crocodile	ŋgǎn
croquer	kòglò1
rouler	pɔĺgân
crue	ì-bɛd́ə1̂
cuisinier	kúgâ
cupide	bì-jə́m
Cythère	dabema
dartre	ŋ̀-ŋɔŋ́
début	mə-̀kází
déchirer	ɲàbì
déclencher	càg
décroître	səg̀
devoir	yɛɛ̀ǹì
déféquer	nɔb́ɔ
défrichage	lyâ
difficile	lɛd̀
domicile	à-tán
Douala	ɛẁálɔ́
douter	pɛd̀nì2
dépassé	làmbà
déprimé	kùlbà
dépuceler	tàn
dresser	nəb̀nə
dresser	límbâ
effleurer	kòbì
détester	pəm̀2
dévoiler	páŋâ
dévoiler	kúmdâ
ekoune	ì-təŋ̀
embêter	gəŋ́zə
encaisser	bábî
enfant	m-ɔŋ̀ɔ́
enflure	ɛ-̀bǐb
enfoncer	dɔb̀ì
engendrer	bònì
entailler	sàŋ1
esclave	ù-lwǎ
espoir	ɛ-̀pìdí
exciter	səg̀lə
exemple	mbùlná
exposer	cɔǹì
faible	təg̀bə
ferment	ɲjàgà
fermer	pɛd̀bàn
feuille	ɛ-̀wúâ
fiable	bəm̀ə2̀
flèche	m̀-pàn
forgeron	lúlúâ
foule	ŋ̀-kùnà1
fraîcheur	à-vɔ
frapper	kùŋlà
fringale	ù-záŋ
fromager	d-úmá
frère	mɔꜜ̌ɲáŋ
fête	ì-zə̀zàŋ
fétiche	ɲjàmà
furoncle	d-wǎd
géant	ŋ̀-kə́mə
garder	bàglàn
gauche	mə-̀yál
genette	ɲ̀-cíŋ
genou	ǹ-tîmgì
gentil	ù-sə̀sà
germe	m-ɔŋ́nɔ̀
glissant	tɛl̀
génitales	zùd
généreux	à-kàb
goûter	ì-pìzà
gourmand	kpàg2
gourmet	ù-lwàd
gousse	ì-kòglò
grand	ɲ̀-ɲóm2
grappe	ɲ̀-cág
grappe	ì-záŋdá
grêlon	ɛ-̀tâg2
grognon	búnbâ
gronderie	mbám
gros	kəb̀kə̀bə
habile	à-kəŋ́2
habiller	bwád
gâteau	kpímdá
guetter	dəŋ́bə
habitude	púúlá
habitude	dìŋ1
hanche	ì-bɔg̀1
heure	ɛ-̀wòlò
heurter	wúbnà
hibiscus	ì-sǎŋ
histoire	ndɔŋ́
hochet	ì-ŋgàlì
honorer	səǵî1
hérisson	mbəb́
igname	ɛ-̀lɔǵ
hâte	mbògmbòg
ilomba	ì-təŋ̀
imbécile	zəz̀è
inciter	pɔŋ̀lɔ
incliner	sɛńî
information	pɔ
informer	bɛńî
initier	kəŋ́lə
interdire	cìlà
intestin	ɲ̀-ɲà
intimider	sìzà
introduire	láb
ivoire	m̀-mǎŋ1
jeune	ì-tɔ̀ŋgɔ
joyeux	mì-ntàg
kola	ŋm̀-ŋmà1
larve	ɛ-̀ɲɛd̀
lemongrass	nàŋ
lent	ì-ndəŋ̀2
lever	bɛɛ́d́ə̂
légume	ɛ-̀tɛd́
lignée	ɛ-̀jɔŋ̀
ligne	ɲ̀-cámá
lièvre	ù-kpəŋ̀
longtemps	kɔḿ
longueur	à-jǎb
louche	ì-kwáŋɔ
lumière	m̀-pyà
maison	ɛ-̀bázá
məz̀əg̀ə	pwàl
mammifère	zòl
mammifère	pùŋ
manche	ŋ̀-kɛĺ
mangouste	mbǎg
manioc	ndəŋ̀1
marché	àŋgàdà1
marié	m̀-máání
massage	ì-wúdâ
matin	kəḱídâ
maturité	à-mòd
mbitacola	ɲɛl̀
méchant	tómbô
menteur	nàlbà
mettre	bɛd̀bə
miette	ɛ-̀ɲùŋà
minceur	à-bwád
mission	míswân
moitié	ì-sə̌g
molaire	ì-kəg̀
moment	ɛ-̀pólô
monnaie	síngì
montant	ŋ̀-kòm
montée	m̀-pəb́
moquer	kpɛĺî
moquerie	bì-jǎ
moqueur	à-ɲɔg̀
moracée	à-bàŋ2
morceau	ì-bǎb1
morpion	ì-lád1
mousse	ì-vúvûz
mouton	ǹ-tómó
mépris	ì-byàní
mépriser	byànì
mûr	ì-lə̀ləg̀
nabot	ì-ŋgəg̀ə
nombre	nwàmɔ2̀
nouvelle	ndwà
oblique	sɛńî
numéro	nwàmɔ2̀
nymphe	kúŋgúzâ
oiseau	ù-tɔg̀
oiseau	ɲjɔĺí
oncle	paternel
ouragan	ŋ́kûlà
palmier	ì-vóy1
panaris	d-òngò
anouir	bùgbàn
papier	ɛ-̀pəb́
paradis	ndóŋ1
parcelle	ù-kǎŋ
parenté	ɛ-̀jóm
parenté	ɛ-̀ɲǎŋ
paresse	à-təǧ
paresse	à-súg
parfum	àlàbínâ
parsemé	ì-təŋ́
partage	ɛ-̀kàb
passager	ndòn2
patienter	jíbâ
perdrix	ù-kpǎl
peut-être	bɛń
pillage	ɲ̀-cà1
piment	ì-lòbò
pintade	ŋ̀-káŋ
pioche	ì-díkâz
pistache	ŋgwǎn
plante	kùkùmà
plante	ɛ-̀ndó
plein	ɛ-̀ŋgùmà
pleurs	kɔɔ̀m̀
pénible	à-lɛď
poil	mbámdúlá
poisson	ì-lóló
porc-épic	ŋgǒm
pourrir	bɔl̀ɔ
pousse	ù-zǒm2
ousseter	sàmzà
prière	ŋgòglǎn
problème	ɛ-̀vɔ
produire	wúm1
profond	ì-dɔǵ
profond	d-ìmà
prohiber	kàmnì
projeter	vázlâ
provoquer	bàgì
présage	ɛ-̀bə
pâte	mə-̀kàlà
puiser	ləm̀də
épuiser	pɔŋ́zɔ
pulluler	ɲùmnì
ereller	sáánì
estion	m̀-móló
rabougri	ì-kpá
eue	ɛ-̀ɲjəŋ́lə
racleur	ù-jəŋ̀
rallonger	jàbà
récolte	mə-̀kɔ
récolter	kòzì
redresser	nìmì
refus	mə-̀wàd
rejet	m-ɔŋ́nɔ̀
renoncer	jəb̀ì
reposer	wàgbɔ
respecter	kám2
respirer	vòzbò
retenir	hámzân
réfléchir	sóŋ
régime	ɲ̀-cǎz
rhume	ì-bəb̀òm
rigole	ì-sàlgà
rocher	ŋ̀-kóm
route	ɲ̀-ɲɔŋ́1
répit	səǵzân
résine	ŋ̀-kàm
réussir	bùgbàn
safoutier	à-sá
samedi	sɛd́àdé
saturer	ɲɔd̀bɔ
savane	ɲ̀-cǎn
savane	ù-zǒm2
séchoir	ɛ-̀kǎŋ
sciemment	váŋ
scintiller	sán
scrotum	ɛ-̀bìn
secouer	sùgzà
sensuel	sògbò
serpent	ù-kóm
serpent	ɛ-̀jáŋ
serré	kágdân2
service	ì-yóm
servir	ləm̀də
seulement	bəŋ́
sevrage	ì-cìlà
sifflet	ì-lɔŋ́
s'interdire	cì
sissongo	ì-sòŋ
soigner	túŋlâ
soldat	ì-kàdì
solitude	ì-tám
sommeil	ù-jɔ1́
sommet	mbòmbòd
ophage	ì-ŋgɔŋ̀
souffler	jìdì2
souhaiter	tám2
spatule	m̀-mǎy
sperme	mə-̀jóm
sternum	ù-ŋgòn
sucré	zəg̀bàn
support	ɛ-̀lìm
supporter	jíbâ
sœur	mɔꜜ̌ɲɔŋ́
surpris	pòdbò
talent	à-kəŋ́2
tamiser	səg̀zə
tam-tam	ŋ̀-kúl
teinture	dáŋâ
tenailles	cáŋâ
kàdì	kólwónó2
tégument	ì-vùl
tituber	pəŋ̀lə
tomber	pɔĺgân
tomber	kpəz̀ə
onné	ŋ̀-káməń
tordre	nɔg̀làn
tornade	ŋ́kûlà
tour	bɔǵlânà
touraco	kúngí
tourner	cíbdâ
tourteau	ì-jám
train	̀ɲ̀-cínâ
tranchant	vól
ranger	ɲ̀-ɲəŋ́
trébucher	vázî
tripes	ɛ-̀swád
tronc	ŋ̀-kwǎg
trouver	kɔb́2
tubercule	kɔ1́
vaisselle	ù-sò
verser	ləm̀də
village	à-bàŋ1
virage	ɛ-̀kwád
vivant	vəə̀b̀ə
voiture	mət̀úâ
vraiment	pwágɔ
vêtement	ì-jə
abeille	mbúmbûŋ
abura	ì-lə̀lɔm̀
accaparer	hàdbà
accepter	jəb́lə
accroché	bəm̀ə
acide	ì-kpáꜜsáŋ
affronter	bàdnì
aggraver	bɛl̂nì
agonie	mə-̀dúgí
aguerrir	kəŋ́lə
aigre	ì-sə̀sâŋà
aiguisé	m̀-pím
aisselle	mbàkán
ajouter	kòglò2
alliance	ì-làd
alliance	ɛ-̀tǐŋ
allumer	kàlnà1
amarante	kùkùmà
amer	ì-jə́jôlò
amusement	ì-làŋ
angueuk	à-ŋgəg̀
anémique	mə-̀cǐ
anomalure	ŋgwì
antilope	à-jəg̀
aplomb	ɛ-̀lágbâ
appel	ǹ-lɔɔ́ńí
apprendre	yəǵî
appétit	ɛ-̀záŋ
appui	ɛ-̀yə́gbə
appuyer	yəǵbə
arbre	à-ndɔǵɔ
arbre	áꜜlɔǵɔ́
wóódè	ù-ŋgɛĺî
wóódè	ŋ̀-káŋlá
artisan	à-kəŋ́2
attacher	tìŋdà
attendre	mwánî2
aubergine	zɔŋ́1
audace	ɛ-̀lágbâ
balafon	ɛ-̀njáŋ
bambou	ì-kpáz1
banane	plantain
baptême	ǹ-nùùní
bas-ventre	ŋgùd
beau-frère	ɲàlà
beignet	ɛ-̀kàlà
bien	ŋ̀-ŋə́mdə
billon	ù-ndògò
billon	ɛ-̀ndògò
bière	bílíbìlì
blancheur	à-pǔm
boisson	mə-̀ɲúŋ
boisson	bì-lám
bordure	ŋmg͡bág
boîte	ɛ-̀ŋgóŋô
bouchon	ì-dìbgâ
bouderie	bì-jám
bourgeon	ǹ-tɔm̌
bourgeon	ɛ-̀bìn
bouton	ɲ̀-càŋ1
bouture	ì-swág
braiser	síŋlâ3
branche	ɲ̀-cá1
bretelle	ì-wág1
bâtarde	ɲjɔb́î
caillé	ì-wúwôlò
caleçon	ŋ̀-káná
cancrelat	ì-bám
capsule	ì-dìbgâ
castré	ŋm̀-ŋmǎg
cataracte	ù-ɲǎŋ
cercueil	ì-zímí
chagrin	ù-kùgà
champignon	ì-já
chandelle	ù-bàg
happer	cɔb́dân
chassie	pɔd́ɔǵ
chat-tigre	mbày
chef	ŋ̀-kúŋkúmá
chez-soi	ì-bógî
chimpanzé	wɔg̀ɔ
chlamydia	ɲjíbâ
cicatrice	ndól
citronnelle	nàŋ
célébrer	lùgzà
cloche	ɛ-̀bəŋ̀í
clopiner	cəḿgə
cloque	ì-tə́tóg
commencer	tádî
comparer	vəg̀nə
onomie	mə-̀zɔý
conraua	goliath
conseiller	ləb́
conserver	bàglà
construire	jɔǵ
contrefort	ǹ-nì
convoquer	báŋdâ
coquin	ǹ-tàndàŋ
corbeille	bánâ
courge	ɲ̀-ɲəŋ̀1
crevette	ŋ̀-wǎz
criquet	ì-tàngí
cylindre	kúdâ2
débattre	cáŋdân
débauche	ì-bàmà
début	mə-̀tádí
décéder	jəg̀zàn
déchirer	làmdà
déchoir	pɔĺgân
déclencher	bólî
découper	sàŋlà2
demi-tour	kwád
dermatose	ɛ-̀kɔ
dessin	ì-və̀glà
défaut	ɲ̀-cwǎz2
défendre	kàmnì
défense	m̀-mǎŋ1
défriché	mə-̀lí
défricher	pùb1
digue	ŋm̀-ŋməǧ
dimension	ndàm1
direct	kpəb́əǵ
discours	ì-kàd
disette	ɛ-̀jəb́
disparaître	dáŋ
disputer	sáánì
distance	ù-jǎb
divinité	à-zàmá
déloger	kúglânà
dorloter	yəg̀lə
doux	ì-vəv́ɔ2̂
déposer	bɛd̀bə
dépouilles	ǹ-tú
dépourvu	ǹ-nəŋ́
déraciner	tə1́
déraciner	pùmlà
déranger	gəŋ́zə
dresser	nəg̀bə
dérouter	lɛz̀1
détériorer	sùn
embusquer	kwàlì
empreinte	ɛ-̀bɔ
encourager	págî
endroit	ɛ-̀pólô
enflammer	káb3
enflure	ù-bǐb1
entretenir	pílî
escarpé	ndòndòŋ
esclave	cúgzɛd̂
essayer	vəg̀là1
excrément	ɛ-̀bí
exorbité	ì-ndòd
expulser	tídnà
fardeau	mbəg̀lə
fermer	pɛd̀nì1
fessée	twànìpáb
feuillage	ǹ-tǔd
feuille	ɛ-̀pəb́
fissures	kəg̀ə
flamme	ŋ̀-kàblà
flaque	ì-tə̀mgə
féliciter	tàmnà
flétrir	jɔg̀làn
formidable	kòòŋ
fragilité	kəĺə
Français	pùlàsí
franc	kpəb́əǵ
frère	mɔꜜ̌ɲɔŋ́
fructifier	pòlò
glaire	bì-lìgdì
goulot	mɔŋ̀bán
gourmand	kòkòd
graisse	ɛ-̀vɔŋ́
grand	kòŋgógô2
grand	ì-bə̀bəǵ
grelotter	ɲàmnì
grenouille	d-ǎz
grouiller	ɲùmnì
gâteau	ŋ̀-kóngí
guérison	mbàbì
habitude	pəm̀1
haleine	ɛ-̀kàg
hameçon	ɛ-̀sɔŋ̌
harceler	gəŋ́zə
heureux	mì-ntàg
homonyme	ì-yòlò
hésitant	sìgsìg
humour	ì-lɔb̀í2
imbattable	kòòŋ
imiter	jəǵlânà
incendier	bɔg̀ì
indolent	ləm̀zə
interdit	səḿ1
interdit	pòdbò
ironie	ɲ̀-ɲɔŋ́2
irrespect	ù-lág
irriter	búlgân
Irvingia	àzàŋà
joyeusété	ì-làŋ
jumeaux	mì-vyáz
langue	ŋ̀-kɔĺɔ
lavement	wàdnì
lecture	ǹ-láŋní
léger	ì-vəv̀ɛz̀
lion	ì-ŋmg͡bəḿ
lisière	ŋmg͡bág
oignement	ù-jǎb
long	ŋ̀-kɔ́ŋlɔ
loquacité	à-nùŋ
macabo	ɛ-̀bàŋà1
lune	ŋm̀-ŋmɛľ
magistrat	lɔýâ
maladie	bɔɔ́ĺó
məz̀əg̀ə	ù-dàg
malchance	àsùdà
malheur	ɛ-̀màlá
mammifère	sósô
mammifère	cígdî
manche	ŋ̀-kɛǹ
manière	ɛ-̀kɔm̀
massage	m̀-máb
médicament	ndwì
méditer	bìzlànà
menton	ì-yə̀gzà
méfiant	ù-bàŋgí
minute	ì-nútɛn̂
momentané	ndòn2
monnaie	ì-kpàm
montant	ǹ-núm1
monticule	ì-kǒl
mouche	bəb́əŋ̂ə
mourir	màŋzànà
movingui	ì-jɛǹ
murmure	mə-̀ɲíŋ
musicien	m̀-mòm
musique	mə-̀zíg
musizi	ŋ̀-káŋlá
naïveté	ì-ləŋ̀ə
neuf	ŋm̀-kpámgí
nocturne	mbànà
non-mûr	ì-bɔd́ɔ
notable	ɲ̀-ɲóm2
nymphe	ɲ́ꜜcígá
oiseau	ɛ-̀pəb̀
ombre	ì-vəv́ɔ1̂
omoplate	ɛ-̀bán
origine	ɛ-̀bòní
palmier	ɛ-̀lɛń
panier	ɛ-̀ŋgùnà
paquet	ì-kúngà
paquet	ɛ-̀púná
arpillé	mbíꜜɔŋ́
passereau	ŋgwàn
pauvre	m̀-múmúá
pédoncule	ɲ̀-cì
pellicule	ì-báz
pensée	ɲ̀-cògní
icerie	ì-pàtìlá
pigeon	ɛ-̀pəb̀
piment	ì-kpə̀bà
piquant	ì-jɔy̌
pistache	síŋlâ1
piétiner	kwágdɔ
placenta	ì-sòg2
planche	ɛ-̀bám1
planté	m̀-bèèní
plante	vəv̀àzá
plante	ì-tóndó
plongeon	ì-làz1
plume	ù-tə̀glə
pénible	ɲ̀-jǔg
pénétrer	ɲíŋlâ
pénurie	ɛ-̀jəb́
poêle	yáŋə́yâŋà
polygamie	bàgá1
potamogale	ì-jè
potiron	ɛ-̀bɔǧ
poursuivre	bəŋ̀
ouvantail	cìcî1
prison	m̀-mɔg̀
propre	m̀-púbní
proscrire	kàmnì
pétiller	dìglàn
pugnacité	ù-lág
purée	mə-̀njáná
artier	ŋm̀-ŋmà1
pygmées	bə-̀kòy
raconter	láŋnì
raconteur	ǹ-nây
réchauffer	báb1
récipient	d-əb̌
redonner	dúgnà2
refaire	tìmnì1
refaire	dúgnà1
regard	mə-̀tálí
remplir	ɲɔd̀bɔ
reproches	bì-jò
reste	mə-̀lígí
retard	mbúmbúâ
retrousser	tùnì
richesse	à-kúmá
rémunérer	yágnà
rondelet	ì-ndód
roter	ŋmg͡bəg̀2
répondre	jəb́lə
réponse	ì-yàlná
sable	ɲ̀-cɛl̂gì
ucter	ŋmg͡bəg̀2
réveiller	vɛl̀ə
salutation	kónó
scarifier	kpɛd̀
semence	m̀-mól
simplement	bəŋ́
soigner	sáábân
souffrir	tíblá
sourire	mə-̀múŋ
soutenir	yəǵə
sépulture	sɔŋ̀2
succès	ŋ̀-kàbní
sucré	ì-zə̀zəg̀
suivant	ì-tógnì
supporter	zòmò
suspendre	kɛl̀ì
suspendu	ságbâ
talon	ì-kílŋgìz
tenailler	pìmlà
terrasser	pùmlà
terrible	m̀-mə
toilettes	ì-dúg
tontine	ì-sùznì
tordre	ɲwàglàn
traiter	nəŋ̀lə
trancher	səḿ2
traîner	bwàdbàn
traître	ǹ-nəm̀ə
travail	pùpúlà
vaciller	pəŋ̀lə
vieillir	jòòmbò
énement	bì-dǐm
vérité	bəb́ɛĺə
abandonné	pùdbà
acariâtre	à-lɛ̀d
accaparer	nàdbà
accouder	yəǵbə
accoupler	jàmnì
accrocher	kɛl̀ì
accrocher	hámzân
accrocher	bəm̀bə
accrocher	pùlnà
allonger	sámlán
allumette	ì-ɲəm̀
ampoule	ì-tə́tóg
amusant	ì-lɔb̀í2
annoncer	yɛd́nə
apôtres	àpóstɛl̀
appliqué	bəm̀ə2̀
arbuste	bəǵə1̂
aérophone	ì-làn
assécher	síŋlâ3
assongho	ì-sánî2
attention	ù-kálá
babouté	bə-̀búdî
aveugle	ǹ-díndím
asilic"	mə-̀sə̀b
belle-sœur	ɲàlà
belle-sœur	mbómó
blessure	ɛ-̀vəŋ́
blindage	ì-jómí
bluffard	bì-jàŋ2
bosse	ì-kəḱóngí
bosselé	bì-tútúg
bracelet	ɲ̀-cəǵ
braisé	ŋm̀-kpɛĺ
bravade	ù-bàznà
brouette	ì-kálíd
brusquer	sìlgànà
callosité	ǹ-nàn
callosité	ì-bágî
calvitie	ɛ-̀yán
caméléon	jɔŋ̀gwé
caquetage	ù-dwád
carburant	ì-sâŋz
écarquiller	nɛd̀
carrefour	màbgán
castrer	ŋm̀-ŋmǎg
champignon	mbɛĺ
charançonné	dúŋ
chasseur	ǹ-sòmò
chaussures	ŋgòb
heveau	ɛ-̀ndùgà
chicotte	ŋmg͡báz
chipoter	mángânà
chétif	ŋm̀-kpáŋ
châtrer	ŋm̀-ŋmǎg
circoncire	kɛl̀ə
clôture	ù-ŋgólô
cobra	ŋgɔj̀ɔ̀mɔ
coiffure	ì-lád2
coliques	bì-lɔǵ
coléoptère	lélê1
commission	ù-lóm
comparer	vəg̀nì
compliqué	ɲ̀-jǔg
compositeur	ǹ-tə
connerie	ì-bùbùà
conseil	dɔḱtɛn̂
construire	làzì
course	ŋm̀-ŋməĺ
coutume	ɛ-̀kəŋ̀2
critique	ù-bàŋgí
croche-pied	báŋ3
Cythère	kàzmáŋâ
déborder	lòbzànà
déchiré	ɛ-̀ŋgəŋ̀
découper	səǵî2
denture	bì-kə̀g
dessiner	vəg̀là2
dégoûtant	ɲɔd̀ɔ
difficile	à-lɛď
diffuser	bəǵlə
discours	ì-jə́gî
disséminé	ì-təŋ́
dépotoir	ì-kùkùn
drageon	m-ɔŋ́nɔ
effaroucher	pùb2
détester	pəm̀nì
effrayer	sìzbàn
emporter	búlgân
endurance	à-zòmò
enfoncer	pɔg̀lɔ
enseigner	yəǵlə
entorse	ɲwàglàn
entêtement	ì-vág
envoûtement	kóŋ
escargot	ǹ-náŋ2
esquiver	sɛl̀gàn
européen	ǹ-táŋní
excellence	ù-zúd
excuses	bì-jùùgá
expliquer	pɛl̀nà
fanfaron	bì-ŋgàn
fatigant	təg̀nì
faîtière	m̀-móŋ1
femme	ɲ̀-ɲə́ꜜɲá
fente	ì-sə̀sâlà
feuille	ì-tóndó
flagornerie	mbòl
fossé	m̀-mə́məǵ
fouille	m̀-págní
fourchette	ì-lúm
fraction	ì-cíìgà
francolin	ù-kpǎl
funèbre	ì-sánî1
gingembre	njínjâ
glorifier	səǵî1
générosité	à-kàb
grand	ɲ̀-cə̀mlə
grenier	ɛ-̀ŋgùnà
habanero	ì-lòbò
habituer	jəm̀zàn
habituer	jəḿlâ
hachette	ì-ndɔŋ́
hanneton	kàŋgázâ
hippopotame	ŋgǔb
hirondelle	ndɛl̀
ignorance	ù-dímí
hylochère	ì-ŋgág
hypocrisie	ǹ-nàn
inattendu	bì-dǐm
incrédule	bì-sóy
indigestion	sǔn
inexorable	àbɛ̀n
infirmité	ì-jəḿ
insecte	óbónítô
insistance	ì-vág
insolence	ù-lág
insolence	lágbâ
intestin	ǹ-náŋ2
invective	ì-kàg
invoquer	səǵî1
jointure	mə-̀làd
larmoyer	ŋgàŋlàn
latex	mə-̀kəḿdâ
lenteur	ì-ndəŋ̀1
loutre	ɛ-̀bàŋà2
lunettes	bì-yɛ́n
maltraiter	pìmlà
mammifère	vyɔŋ́
mammifère	ù-sǒg
mammifère	ù-jàm
mammifère	mbɔy̌
mammifère	ì-súm
maniguette	ndóŋ1
manœuvre	cúgzɛd̂
asculer	ŋm̀-ŋmǎg
maître	ɲ̀-ɲəǵlə
maîtresse	ì-bwàn
maugréer	dɔg̀dàn
méchanceté	à-jòl
menottes	háŋkwâb
mensonge	m̀-pùgá
menuisier	kábínâ
moelleux	ì-bùbùd
moineau	mbàŋkùmà
mollet	ŋm̀-ŋmɛń
monnaie	d-ɔĺɔ̂
mortier	ɲ̀-cɔb́ɔ
moucher	sɔz̀bàn
moucheron	ù-bǐg
moustache	ǹ-nàg
moustache	ɛ-̀bùb
multiplier	pòlò
multiplier	bùlà2
non-mûr	ì-káꜜsáŋ
non-mûr	ḿmáyâgà
non-mûr	ì-pɔĺɔ
non-mûre	ì-jwází
nuisance	mə-̀tóm
obscurité	d-ìblâ
ochnacée	ì-kógó
oiseau	ŋm̀-ŋmǎm
oiseau	mbàŋkùmà
olacacée	ì-wómî
olacacée	à-ŋgəg̀
orgueil	à-ŋgɔ̀ŋɔ
outrepasser	dàŋ2
ouvert	pɔɔ́b́ɔ̂
oviducte	ǹ-náŋ2
pantalon	twàlàsí
paquet	m̀-mwàm1
paralysé	ì-bɔǵ2
parapluie	ù-tàn1
parent	ì-vúvúmní
passage	ɲ̀-ɲɔŋ́1
passoire	ì-kùdgà
pauvreté	mə-̀bwâ
pellicule	ì-vùl
percevoir	nùmlà
pièce	tɔl̀ápɛn̂
pistache	ɲ̀-cà2
pivoter	cìŋlànà
plantain	zwàgbɔ
plantain	ì-sɔŋ́
plantation	à-púb
plante	ɲ̀-ɲəŋ̀1
plante	ɛ-̀jwàmí
plantoir	ǹ-tɔŋ́1
poitrine	mìŋ-kùg
poêle	ì-pìŋgəŋ́
policier	bəz̀ìmì
ouvantable	cìcî2
premier-né	ǹ-tól
problème	ì-tɔm̀
proclamer	yɛd́nə
promesse	mə-̀tǐŋ
prospérer	bùgbàn
provision	ì-kàgá
préparer	kòmzàn
prétentieux	məm̀
pétrole	kàlàsínâ
erelleur	ǹ-sáánà
ramolli	m̀-múúní
rancunier	zíŋbá
rasage	ì-kə̀ŋbàn
rassasier	ɲɔd̀bɔ
rassasier	njɔǵ
rassembler	kóznò
ravin	m̀-mə́məǵ
récolter	ləŋ̀nì
récompenser	págî
recoin	ɛ-̀ndúmgí
redresser	ɲòònì
refuseur	àbɛǹə̀
rejeter	bɛɛ̀ǹì
remarquable	kòòŋ
remèdes	mə-̀bálá
remplacer	lɛz̀2
renverser	kpəz̀ə
renvoi	ŋmg͡bəg̀1
restituer	dúgnà2
retourner	tìmnì2
revendiquer	kál2
réprimande	bì-jò
réveiller	vəb̀ə
sage	m̀-pə̀mpəǵ
salive	mə-̀ndɛǹ
sanglier	ì-ŋgág
sceptique	bì-sóy
semailles	ɛ-̀běy
semence	kɔŋ́gwáz
s'enflammer	káb3
sentir	wɔǵdânà
serpent	ɲ̀-cəg̀
serviteur	ì-túgâ
silencieux	pɔḿ1
sinistre	ɛ-̀màlá
sitatunga	ì-mbùl
souffle	m̀-vòzbò
soulever	səǵdə
sourd	ǹ-də́ndɔǵ
souvenance	ù-bíz
spatule	m̀-məb̌
surnom	mə-̀bádnà
sursauter	sìlgàn
surtout	áꜜdáŋdâŋ
talapoin	ù-ŋgɛž
tanière	ŋm̀-ŋmǐl
termites	bì-wàz
termites	bì-càgà
terrier	ŋm̀-ŋmǐl
testicule	ɛ-̀bìn
totalement	lìbìg
toucan	ŋm̀-ŋmǎm
touraco	ŋm̀-ŋmǎm
tournant	ɛ-̀kwád
tourner	cìŋlànà
tourniole	d-òngò
trembler	pògbàn
troubler	búlgânà
trouver	ù-sɔ̀mì
tuméfié	bì-tútúg
vaccination	mbǎŋ
vaillant	ŋ̀-káŋá
urine	mə-̀ɲɔĺgí
variole	mbàlmànà
vendredi	pùláꜜdé
vengeur	ŋ̀-kùnà2
vernonie	ɛ-̀tɛd́
véhicule	ì-bígdâ
vieillesse	à-jǒm
vigoureux	mbəm̀
viscères	bì-səǵ
visiteur	ɲ̀-ɲəŋ́
visqueux	lìgdàn
visqueux	kəŋ̀bə̀
volontaire	ù-váŋ
accueillir	sòzbò
aggraver	mɛńgân
alcarazas	kúlwàdá
alentours	ɛ-̀vɛl̀
allumettes	m-ásîz
ambarella	kàzmáŋâ
amende	ì-bəb̀ɔŋ̀
antillais	ì-lòbò
antipathie	mə-̀cǐ
apocynacée	à-kùg
wóódè	ŋ̀-kànəŋ̀2
attraper	g͡bɛl̀ì
augmentatif	m̀-mə
autorisation	ŋgùl
barrage	ŋm̀-ŋməǧ
barrière	ù-ŋgólô
bastonnade	ì-kùm
bastonnade	ì-bɔb̀
bavarder	pɔb́lân
beau-parent	ɲ̀-cǐ
bonbonne	ɛ-̀ŋgámá
bouillonner	lɔb́2
bouteille	ǹ-nɔm̀ɔ
bouture	m-ɔŋ́nɔ̀
brouillard	ì-jwǎn
calebasse	ì-kpáz2
calebasse	ɲ̀-cáz
camion	kɔm̀kɔ̀mɔ
cancrelat	pəṕéy
cartilage	káŋgázâ
catalogue	kàdàlóg
cercocèbe	ɲ̀-càg1
chamailler	sáánì
chantier	ŋ̀-kóŋó
charançon	kàŋgázâ
chasseur	ɲ̀-còmò
chercher	həǵbân
claudiquer	cəḿgə
célibataire	ŋ̀-kɔ
commandant	ɲ̀-jôy
complètement	kpád
compléter	dìbgànà
condiment	ì-cìdgà
confondre	cɛɛ́ńì
conserver	bàglàn
contraindre	nɔd̀ɔ
contrefort	ǹ-tím
correct	ŋ̀-ŋə́mdə
couvercle	ì-búdgà
couvre-chef	ǹ-tóm
crédulité	ì-ləŋ̀ə
creusage	m̀-págní
cueilette	ɲ̀-cáb
cueillette	ì-kɔ1̀
Cymbopogon	ùsàŋà
déboucher	sògzò2
débrouiller	bímnì
débusquer	kúglânà
déchiqueter	làmdà
déclencher	lɛńə
déconcentrer	sòlò
décortiquer	tágî1
demandeur	ɲ̀-cílâ
dépouiller	pɔĺî
drague	ɛ-̀ndómní
déranger	ndəǵlə
ebenacée	məv̀ínâ
effondrer	sùglàn
déterminé	bəm̀ə2̀
déterminé	ŋgàzbà
engokom	ì-kə́kɔḿ
entièrement	lìbìg
espiègle	ǹ-tàndàŋ
excréments	mə-̀bí
excuser	bì-jùùgá
fabricant	ŋ̀-kòmò
famille	ì-vúvúmní
féculent	ì-bɛd̀gə
fermable	pɛd̀bàn
flatterie	ì-wàngɔ
flatuosité	ɲ̀-cùl
forficule	óbónítô
fouilleur	m̀-vùnà
fourmi	ù-sə́ꜜswán
fragile	kəg̀lə̂gə
fraternité	ɛ-̀ɲǎŋ
gestation	ɲ̀-cìlà
gesticuler	pùblàn
globuleux	ì-ndòd
gloutonnerie	həb́
gémissement	ǹ-tàd
goulûment	mɔŋ̀bán
gourmandise	kpàg1
ratignure	ɲ̀-cɛĺ
grommeler	dɔg̀dàn
grossesse	ɲ̀-cìlà
grosseur	ɛ-̀nɛńí
habilé	m̀-bwádní
importuner	gəŋ́zə
inflorescence	sǎm
infortune	bàdlɔǵ
inséparable	ù-báz
instrument	ì-kɔ2̀
instrument	ì-làn
intelligence	pəg̀
interdiction	ì-cì
interloqué	pòdbò
interstice	pìgzán
lemongrass	ùsàŋà
lombric	ɲ̀-ɲìlìg
lotofa	ŋ̀-kànəŋ̀2
louange	mə-̀səǵî
lépreux	ǹ-zəꜜ́zám
luciole	ŋgəꜜ́ŋgéy
mammifère	ɲ̀-ɲǒg
mammifère	ɲ̀-cá2
mammifère	ɛẃúnî
manguier	à-ndɔǵɔ
marécage	ì-lɔb̀í1
mariage	m̀-máání
massivement	lìbìg
militaire	bəz̀ìmì
négligence	ì-lɛž
nonchalant	ləm̀zə
obstination	ndɔǵ
offrande	àdmúsɛn̂
oiseau	ɲ̀-cìɲcàl
opération	ì-sàlgà
parasolier	à-səŋ́
parasolier	kɔm̀ɔ
paresseux	təg̀bə
passereau	ù-tɔg̀
passereau	ɲjɔĺí
passereau	ɲ̀-cáŋ
pincement	ì-mwázî
plante	ŋ̀-kɛ́ngà
pénitence	mə-̀túg
pourriture	ì-bwǎl
profondeur	ì-dɔǵ
promettre	mə-̀tǐŋ
pétiole	ŋ̀-kɔǵ2
pugnace	bì-ləĺág
puérilité	à-mɔŋ̀ɔ
on-dit	ì-kúkwâlɔ̀
rumeur	ì-kúkwâlɔ̀
réchauffer	wáblɔ
réclamation	ù-tám
recherche	ɲ̀-cáb
recompenser	yágnà
ection	ŋ̀-kɛɛ́ńí
remerciement	ŋgǎŋ
rencontre	ndóꜜbnó
ressembler	pòònì
ressentiment	ì-bá
retenue	mbògmbòg
retourner	vyàŋlà
rhumatisme	ɛ-̀kàŋ
rhumatisme	ù-ɲál
résistant	tíbdân
rugueux	ì-səs̀âŋà
ruisseau	ɲ̀-càbgà
rythme	bì-zəḿlə
s'accumuler	dìlnà
s'aggraver	bɛl̂nì
saison	ɛ-̀sómló1
sarcastique	pyàŋà
s'ensauvager	kùn1
s'installer	ŋgàná
strabisme	mì-lə́ŋ
sursauter	sìlgàn
taille	ɛ-̀ŋgɛd́gí
kàdì	ì-mbə̀mbəŋ́
toujours	ŋgɛńâ1
transitoire	ndòn2
transport	mbəg̀lə
transport	ì-bànà
travail	ŋ̀-kòglò
tremplin	ɲ̀-ɲɔŋ́1
tromperie	ǹ-dùgní
troubles	ì-cəc̀òm
troupeau	ŋ̀-kùnà1
tubercule	pɔɔ̀ḿ
turbulent	pəb̀nì
uniforme	bəz̀ìmì
verbenacée	ì-vúl
vocifération	mbám
vêtement	ɛ-̀ŋgəŋ̀
Zanthoxylum	bòŋó
accouché	ɲ̀-ɲə́ꜜɲá
agitation	ì-cəc̀òm
apathique	kólwónó1
arrachement	ì-làlì
attention	púzlânà
Bamiléké	ŋgɛĺàpíz
boiteux	ɲ̀-ɲə́ɲəḿ
bravoure	ù-díꜜdígâ
cachotterie	ù-sɔg̀
camionnette	ù-pəb̀
carambolage	tíndîŋ
cassimango	kàzmáŋâ
catéchiste	kàdàkíz
catéchèse	dɔḱtɛn̂
Cercopithecus	mona
Cercopithecus	pùŋ
chatouiller	ɲwàmlɔ
chrysalide	ɲ́ꜜcígá
claudication	ù-bà
commandement	ì-jôy
conciliabule	ì-són
condiment	ì-zə́záŋ
couverture	m̀-pìŋá
culminant	mbòmbòd
cylindrique	kúdâ1
déclencher	kpázlâ
dégoûtant	ɲɔd̀bɔ̀
dégringoler	swâdnì
dignitaire	m̀-mɛń
discrétion	mə-̀sɔ̌
démesurée	pídgân1
désapprouver	hàmnì
désordonné	mbíꜜɔŋ́
ebebeng	ì-bə́ꜜbəŋ́
effronté	bì-ləĺág
effronterie	ù-lág
embranchement	pálâ
empresser	mbògbàn
exagération	ì-pɛz̀
exsudat	mə-̀kəḿdâ
familiarité	ŋmg͡bà
fraternité	ɛ-̀jǎŋ1
gourmand	ndɔg̀bɔ̀
grand-parent	mbámá
grelotter	ɲàmɲàmà
Guibourtia	ù-vəŋ̀
imitation	mbàŋzàná
impertinence	ù-lág
impudence	ɛ-̀lágbâ
indéfectible	ù-báz
indigence	mə-̀pyàd
inqualifiable	d-àm
insolence	ɛ-̀lágbâ
intention	ɲ̀-cògní
irvingiacée	àzàŋà
kilomètre	kílmɛd́ə
lamentation	ǹ-táŋá
lapsus	ɲ́cɔb́ꜜdáná
lenteur	ù-tə́təǵ
longitudinal	ì-pàz
malchance	bàdlɔǵ
malédiction	ì-jɔg̀
malheureux	tíndîŋ
maltraiter	pɔŋ́zɔ
mammifère	ù-ŋgɛž
mammifère	ɲ̀-càg1
mammifère	ɛ-̀sùná
mille-pattes	ŋgɔy̌
minuscule	cəćɔ́dɔ
monnaie	tɔl̀ápɛn̂
montant	ì-bɛd́ə2̂
moquerie	ì-kpɛ́lí
nombreux	ì-bə̀bəǵ
non-aiguisé	m̀-pím
obéissance	mə-̀wóg
obscénités	pódgân
omoplate	ì-bəb́áz
palmier-raphia	zàm
persévérance	ì-vág
phlyctène	ì-tə́tóg
pistache	ì-kɛĺgí
plaisanterie	ì-làŋ
pression	mə-̀bádná
progression	ù-jìz
prolétaire	cúgzɛd̂
provocateur	bàgnì
provocation	mbàgnì
préparation	ɲ̀-ɲám
présomption	ù-məm̀
prétexte	ɛ-̀kɛl̀bə
pâturage	mə-̀díígà
punition	ì-ndə́glə
asi-mangue	kàzmáŋâ
ravin	ŋm̀-ŋmìglìm
recensement	ì-láŋâ
recherché	jəŋ́bân
revendication	mbàŋ
réflexion	ɲ̀-cògní
réparateur	ŋ̀-kòmò
résidu	bì-kpɛz̀gí
rubiacée	ì-ləl̀ɔm̀
uctation	ŋmg͡bəg̀1
ruisselet	ɲ̀-càbgà
s'accoupler	pəb́nì
s'échapper	sɛl̀gàn
scrupuleux	bəm̀ə2̀
serpent	bət́ə́bâŋà
serpent	ŋgɔj̀ɔ̀mɔ
s'incruster	ŋgànbà
sélectionner	tɔb́
sélectionner	pyàlì
soliloquer	dɔg̀dàn
soudainement	ɛb̀ǒm
souffrance	ì-tíblá
soumission	mə-̀wóg
sterculiacée	à-jòz
stérile	ŋ̀-kə̀ŋkóm
sucrerie	ì-zə̀zəg̀
supporter	mbɛǹbə
surprendre	dìbgànà
sympathiser	mbóònì
termites	ì-lə́láŋ
onnement	ŋ̀-káməń
ourdi	ù-ndúndúmgân
transformer	cɛńî2
transmettre	kàlnà2
transmettre	dàànì
transporter	bəg̀lə
trembloter	tɔg̀bàn
turgescence	ɲ̀-cád
évacuation	ì-bànà
vantardise	bì-jàŋ1
xylophone	mə-̀njáŋ
accrochant	kɔŋ́gwáz
agressif	ɲ̀-ɲə́ɲɔǵ
alcoolisé	mə-̀jɔg̀
alluvions	ì-yə́yəǵ
amulette	ì-tályɛǹ2
articulation	d-òòŋò
audacieux	bì-ləĺág
avare	m̀-pə́ꜜmpɔḿ
bavardage	ì-kókómnó
belle-fille	m̀-mɔḿ
bistourner	ŋm̀-ŋmǎg
blessé	ì-kpəḱpɛ̂lì
catastrophe	tíndîŋ
catastrophe	ɛ-̀màlá
cecropiacée	à-səŋ́
centimes	tɔl̀ápɛn̂
chamailleur	ǹ-sáánà
chaussette	zìtwágnì
coléoptère	kòŋgógô1
commérage	ɲ̀-cwǎz1
commérage	ndəńdɔ́ŋ
compliquer	pɛd̀gàn
complément	ì-bɛd̀gə
conjonctivite	àpòlô
connaissance	ù-jəm̀
coquetterie	bì-jàŋ1
cotonnade	mbámdúlá
céphalophe	ù-kpə̀ŋ
crinière	ɛ-̀ɲjə́ŋlə
racontar	ì-kúkwâlɔ̀
Cymbopogon	citratus
déception	ŋm̀-kpálá
définitivement	kpád
esquisse	mə-̀səb̀lə
extraction	m̀-págní
fantaisiste	bì-jàŋ2
gargoulette	kúlwàdá
gloutonnerie	ŋgəb́
gémissement	ɲ̀-ɲón
grenier	ŋmg͡bɛ́lmí
grenouille	ŋ̀-kɔŋ́ɔ
grenouille	ɛ-̀bəm̀
habillement	m̀-mwád
identité	ì-dàŋdìtê
incantations	kâlnà
inflammation	ŋ̀-ŋɔ
insensible	kólwónó1
insincérité	kɔŋ́lán
intelligent	à-kəŋ́2
intelligent	kəŋ́bə
intentionnel	ù-váŋ
Irvingia	gabonensis
éphantiasis	ɛ-̀tín2
malade	ŋ̀-kúꜜŋkwán
médisance	ndəńdɔ́ŋ
moustique	ì-ɲəɲ́ɔŋ́
opiniâtre	bì-ləĺág
parasolier	ɛ-̀səŋ́
perturbateur	bì-dǐm
phyllanthacée	à-sám
planche	ì-bə́ꜜbɔǵ
potamochère	bəm̀ə1̀
prioritairement	tá
préparatifs	ŋgòmzàn
religion	ɲ̀-ɲəb́ə2́
ressemblance	mbòòní
retourner	vyàŋlànà
reviviscence	ɲ̀-cád
rhamnacée	ŋ̀-káŋlá
sanglots	mə-̀səǵbə
sauterelle	m̀-múlgí
scarifications	mbǎŋ
soulèvement	ǹ-tééní
soutien-gorge	bwàdí
suffisance	à-ŋgɔ̀ŋɔ
support	ɛ-̀yəǵbə́
surprendre	sìlgànà
sympathique	ù-səs̀à
trouble	ì-búꜜbúlgí2
turbulent	m̀-pəb̀ní
véhicule	kɔm̀kɔ̀mɔ
virginité	m̀-pɛĺî
voleur	ŋm̀-ŋmíꜜŋmíb
accouplement	m̀-pəb́
admonestations	bì-jò
adolescente	ndɛd̀gí
afaiblissement	cəg̀1
andinding	ì-ndə̀ndìŋ
arc-en-ciel	ǹ-núꜜnúm
auriculaire	zəźɛĺâ
avertissement	mbəḿí
belle-famille	bə-̀cǐ
bénédiction	ǹ-sàlní2
boursoufflé	bì-tútúg
boursoufflure	ɛ-̀bǐb
brouillé	ì-búꜜbúlgí2
casse-mangue	kàzmáŋâ
Cercopithecus	ì-súm
happatoire	ɛ-̀kɛl̀bə
chasse-mouches	kâg1
laircissement	m̀-pyà
construction	mə-̀lóŋ
contrefort	ɛ-̀kòngò
dame-jeanne	ɛ-̀ŋgámá
Dendroaspis	jamesoni
déformation	ɲ̀-cwǎz2
dissimulation	mbízí
démagogue	m̀-pìmpyáŋ
déracinement	ǹ-tééní
désobéissant	mə-̀lɔ́
effronterie	ù-bàznà
effronterie	ɛ-̀lágbâ
encombrement	kágdân1
enfantillage	à-mɔŋ̀ɔ
enseignant	ɲ̀-ɲəǵlə
euphorbiacée	ì-sánî2
halètement	mə-̀dàgbà
hésitation	ɲ̀-cə́ŋní
imperméable	rɛǹkɔd́
indiscrétion	ù-váznì
lambeaux	bì-pəp̀əg̀
éphantiasis	mə-̀tín
maladie	mə-̀ŋmg͡bəḿ
moute-moute	ù-pìŋgwě
Musanga	cecropioides
parturition	ŋ̀-kòglò
pendentif	ì-tályɛǹ2
professeur	ɲ̀-ɲəǵlə
Pterocarpus	m̀-mɛl̀
Pterocarpus	soyauxii
récipient	ì-ləə̀ŋ̀ə
responsabilité	à-mòd
rubiacée	ì-ndəǹdìŋ
sapindacée	ɛ-̀wóngí
séduction	ɛ-̀ndómní
surveillant	m̀-màglà
taciturne	ì-ndìndìmà
Tragelaphus	scriptus
turbulence	m̀-pəb̀ní
volumineux	ì-bə̀bəǵ
appellation	ǹ-lɔɔ́ńí
boursoufflure	ù-bǐb1
catéchèse	kàdàkísmùz
catégoriquement	kpáám
cesalpiniacée	ì-jɛǹ
chauve-souris	ŋ̀-ŋəḿ
chauve-souris	ù-tàn2
célébration	ì-bàndùm
conciliabule	ì-sɔg̀ɔ
confortablement	mɛz̀1
consciencieux	bəm̀ə2̀
construction	ŋ̀-kóŋó
consultation	m̀-pɔm̀ɔ
coquetterie	ɛ-̀ŋgwàn
déchiqueté	bì-pəp̀əg̀
Guibourtia	tessmannii
harcèlement	mə-̀bádná
impertinence	ù-váznì
inhalation	ɲ̀-cwànbàn
interminable	kɔm̀kɔm̀
irrévérence	ŋm̀-kpálá
malheureux	ì-ŋgúŋgwál
mille-pattes	ù-lɛ̀də
mortification	mə-̀túg
multiplication	ì-bùlà
obscénités	mə-̀pódgân
ostentatoire	ù-vɛz̀nì
paralysée	m̀-mə́mɔǵ
paralytique	m̀-mə́móg
perce-oreille	óbónítô
pince-oreille	óbónítô
Piptadeniastrum	ǹ-tɔ
programmation	ǹ-tágní
revendication	ŋ̀-kál
ruisselet	ɲ̀-cə́bəǵ
termitière	ɛ-̀sómló2
Abelmoschus	esculentus
articulation	ì-bwágzí
chasse-mouches	ɛ-̀kpâg
désapprobation	bì-jám
désinfectant	bùlátânjó
désobéissant	ndɔǵbɔ̂
enrichissement	ɛ-̀bígí
inflorescence	ɛ-̀bám2
massage	ǹ-wúdnə́ŋgánâ
ordonnancement	ǹ-tágní
anouissemnt	mə-̀bùgbàn
plantain	ìtùnbɔk̂ɔǵɔ
voix	ì-ŋmg͡bəŋ̀mgb͡àm
louissement	ì-búꜜbúlgí1
Cercopithecus	neglectus
glorification	mə-̀səǵî
manifestation	ì-zə̀zàŋ
rauque	ì-ŋmg͡bə̀ŋmgb͡àm
développement	mə-̀bùgbàn
intelligent	m̀-pə̀mpəǵ
sous-vêtement	sáꜜŋgélézí
horizontalement	kɛꜜ́ŋgáná
Piptadeniastrum	africanum
sorcier	ŋm̀-g͡bə́ŋmg͡bɛĺ
droit	lwán
genette	zòl
lever	làgbàn
poser	ŋgàzbà
installer	lùmbà
avec	èè
cou	cíŋ
re	bógô
houer	kù
coût	táŋ
rire	tìl
œil	d-ǐz
lier	làd
lire	láŋ
long	èè
net	púb
ais	tìg
pour	ású
ouser	bá
prix	táŋ
unir	làd
voix	cíŋ
vote	cíŋ
bord	kòn
contre	èè
cric	jəǵ
dur	lɛd̀
feu	ndwân
fier	wóg
arer	vóm
lise	cwáz
gober	mìn
gorge	cíŋ
ever	tɔŋ̀
mil	ù-vùg
mort	à-wú
mot	ì-búg
nouer	làd
part	ŋgàb
peur	pún
re	ɛ-̀cíl
pus	pɔŋ́
itter	tê
trop	dàŋ1
tôt	vúlâ
tête	ǹ-nó
tuer	sìl
voir	yɛń
agir	kɔm̀2
animal	tíd
avaler	mìn
calcul	táŋ
chaux	pəḿ
choses	lǒm
coudre	làd
décès	à-wú
doter	vəg̀
eru	ù-kɔg̀
faillir	yì
faire	sá2
faux	cɔǵ
fâché	wóg
fendre	sàl
fier	à-tód
fil	mbúná
fin	à-mànà
fort	lɛd̀
frire	yáŋ1
froid	sín
grain	d-ǐz
ivoire	vùz
jouer	bòm
lier	lád2
loger	bógô
oges	kàŋ2
lot	ɛ-̀bág
marier	bá
nuit	à-lú1
oindre	síì
opérer	sàl
pays	ǹ-nàm
peine	túg
penser	còg
peser	vəg̀
pied	à-kǒl
pitié	wóg
pomper	póm
poncer	síì
rafler	bòm
rater	vùz
rival	mbán
roue	à-kǒl
sec	ŋ̀-kód
soin	kálâ
sortir	pám
tali	ì-lón
tirer	lúm
roit	kág2
têtu	ndɔǵ
acuer	lóg
user	cəg̀2
viande	tíd
vite	à-vól
vite	vúlâ
zip	ɲ̀-càg2
agiter	pógó
air	ì-vúŋlâ
ajuster	kòm
amour	ì-dǐŋ
appétit	zám
wóódè	ndíŋ
jəg̀	tɛĺî
assis	bógô
avocat	pyâ
avouer	məm̀
ayous	à-jòz
balle	ndàmà
baptiser	dù
barrer	yəǵ
beti	bə-̀tí
blinder	kòm
boîte	ndəǵ
braise	d-âg
bruiner	sáb
hanger	pwàz
hec	m̀-məg̀
chéri	ì-dǐŋ
later	bólî
compter	láŋ
onduire	càm
corne	tɔŋ́1
couver	báb1
creuser	pág
rit	tìlbàn
danser	jəḿ
doigt	ù-nǔŋ
déraper	vóm
encens	ù-tú
enduit	pəḿ
envier	kómô
ex-	ŋ̀-kúz2
fil	ŋ̀-kwǎl
fils	ndómní
fièvre	jóŋ
foi	ɛ-̀pìdí
fondre	sêy
galon	ì-kúg
gravir	bɛd́
gronder	bám
guépard	zěy
guéri	lɛd̀
hamac	hámgì
hévéa	ndàmà
imputer	bád
jambe	à-kǒl
jeter	kúdî
joindre	làd
joug	m̀-mòg
juger	jwáz2
laid	bəb́2
lune	ŋgwàn2
lutter	sìŋ
magie	ŋgàŋ
marier	bálâ
dùgà	dùgnì
mois	ŋgwàn2
neveu	m-wán
nièce	m-wán
noise	cəg̀2
nœud	ɛ-̀tǐŋ
oindre	síì
okok	ù-kɔg̀
opinion	cíŋ
paix	mbwàgí
papaye	pùpó
passer	lòd
passer	lòd
patron	mázâ
pêche	bíná
pile	ɛ-̀bág
pincer	pìg
plumer	pwán
propre	púb
prêter	kòlì
uiser	təg̀
ravager	sà1
remède	byàŋ
repas	ɛ-̀dí
rikio	à-sám
résine	ù-tú
sain	mbwàgí
saisir	sà1
sécher	kód2
sculpter	bà
serrer	kág2
simuler	bád
sortir	vám
s’user	síbâ
taper	bɔb̀
eindre	dímâ
terme	ì-búg
tirer	bímî
onner	kám2
treuil	jəǵ
enter	pəb́2
visite	tál
voir	yɛńî
abachi	à-jòz
abattre	sìl
aboucher	kòm
accord	jílâ
actuel	à-lú1
admirer	kómô
adopter	ɲɔŋ̀
adosser	yəǵ
affaires	lǒm
agrume	òpùmá
aiele	à-bɛĺ
allumer	càg
apposer	bàgì
arbre	à-jòz
arriver	vám
assumer	məm̀
au-delà	kón1
aumône	sádkâ
bec	ɲ̀-cɔŋ̀1
bien	m̀-pàŋ
bosse	ì-túd
bouche	à-nùŋ
caféier	kòpí
calculer	láŋ
chasser	càm
clouer	bòmlò
cogner	bòmlò
cola	ɛ-̀bɛľ
content	wóg
cotiser	sùzà
coupe	ù-kəŋ̀
cour	ɲ̀-cəŋ̀
craindre	pún
rire	tìlbàn
danse	ɛ-̀bóg
devenir	pám
défaire	bɔb̀
diffuser	càm
délayer	pùg2
durcir	lɛd̀à
engueuler	sò
entendre	wóg
espérer	pìdì
faible	mànà
faire	kɔm̀2
fantôme	kón1
farine	ù-vùg
fermer	lɔ2́
fille	ŋgwàn1
flacon	ndəǵ
fondre	síbâ
forme	ɛ-̀bím
frapper	kùd
fronde	ndàmà
frotter	pìg
fruit	ì-bòmó
guérir	lɛd̀
habiter	bógô
honte	sámlâ
inscrire	tìl
instant	kwám
kola	ɛ-̀bɛľ
lignage	mbóg
livre	kálâdà
émier	à-bɛĺ
maigre	kód2
malade	kwàn
malaxer	pùg2
e	ɲ̀-cíꜜɲcím
mesurer	vəg̀
mélanger	sáb
moche	bəb́2
modifier	sá2
mouillé	sín
nettoyer	sò
noix	m̀-mǎŋ2
nommer	yòlò
nourrir	tɔŋ̀
obèche	à-jòz
orange	òpùmá
orteil	ù-nǔŋ
panthère	zěy
papayer	pùpó
pian	ɛ-̀bàdà
picorer	sɔǵ
pion	m̀-mǎŋ2
piquant	jàŋ
piquer	sɔǵ
plan	ǹ-nímŋì
plié	ɛ-̀bág
pondéré	tìg
poste	ŋ̀-kóŋ
poumon	ndàm2
presser	bán2
procès	jwáz1
pétrir	pùg2
purger	pyál
racine	lád2
raie	ì-sàlgà
ection	kɛń
refuser	bɛǹ
regarder	tál
remuant	jàŋ
remuer	pógó
rester	káŋâ
riche	m̀-pàŋ
rogner	cəg̀2
rouler	bígdâ
réparer	lɔ2́
santé	mbwàgí
savoir	jəm̀
siffler	lɔŋ́
signe	ndəm̀1
sombrer	dímâ
tas	ɛ-̀tùmá
tenace	à-tód
tendre	límî
tendre	təg̀
titre	ŋ̀-kóŋ
touiller	sáb
tromper	vùz
vaincre	bɔb̀
vanner	pəb́2
veiller	józê
oquer	sòŋlò
voyage	d-ùlà
abaisser	sùzà
aïeul	m̀-mònì
ahan	ɛ-̀ndəŋ́
aligner	tɛĺî
annonce	ndɔŋ́
annoncer	kàd
annoncer	kàd
annoncer	càm
appeler	lɔŋ́
appuyer	yəǵ
arbre	à-bɛĺ
wóódè	kòkómô
avocatier	pyâ
bûche	mìŋ-kùg
besoin	yáŋnì
bien	kwàgdɔ̀
bientôt	à-lú1
bloquer	bán2
bord	ŋ̀-kɔŋ̀
boucher	lɔ2́
bout	ɲ̀-cɔŋ̀1
brûler	sòblò
butte	ɛ-̀bóm
calomnier	bád
caquet	ù-jəḿ
caqueter	kpál
casser	kəǵ2
chaise	ì-bógî
chanter	lɔŋ́
charger	kúdî
charger	kág2
choisir	twáb
chute	m̀-məg̀
collant	lád2
coller	bàgbà
concasser	bòm
contrée	à-tán
couvert	búdâ
creux	m̀-mɔǵ
cynisme	ŋgɛd́
demeurer	káŋâ
démarrer	càg
dénommer	yòlò
doute	m̀-pɛď
déplacer	pógó
déposer	sùzà
eau	mə-̀jə́g
enfant	m-wán
envahir	lád2
expulser	càm
fatiguer	təg̀
filet	ɛ-̀vɔd́
flair	ɲ̀-cwàn
fouetter	bɔb̀
fétiche	ŋgàŋ
germer	kəǵ2
germer	kəǵ2
goyave	ì-bòmó
grade	ŋ̀-kóŋ
guérir	lɛd̀à
homme	ndómní
insolent	yág
lance	ɛ-̀kɔŋ̌
laver	pùbnì
lutter	pùbnì
marcher	wùlà
marteau	hámgì
mettre	tɛĺî
moitié	ì-tùn1
Monsieur	ǹ-tí
monter	pəb́1
mouvoir	ndəŋ́
museau	m̀-móm
oreiller	pílâ
aisseur	à-tǐg
peinture	pəḿ
pencher	nìgá
percevoir	wóg
petit	ì-kùŋá
piquer	jìdì1
plat	mì-sɔŋ̀
plein	ɛ-̀bóm
plumes	ɛ-̀vùl
poche	m̀-pəǵ
poison	ì-nèy
preuve	ndəm̀1
produire	lòd
protéger	kálâ
pétiller	sáb
puiser	ləŋ̀1
antité	ɛ-̀bím
ereller	cəg̀2
iétude	mbwàgí
rapport	ndɔŋ́
récit	ǹ-náŋ1
recoudre	lɔ2́
repriser	lɔ2́
revenant	kón1
rigueur	ŋgɛd́
rite	ɛ-̀kəŋ̀2
robuste	ság2
rognon	ɛ-̀tám
résonner	lɔŋ́
résoudre	swàm
réunir	tóbnì
sacrifier	cíg
savate	ɛ-̀bâg
seigneur	ǹ-tí
sens	ndìmzàná
sillon	ɛ-̀bóm
solo	láŋdânà
soucier	táŋâ
souvenir	còg
surdité	ndɔǵ
surmener	təg̀
surpasser	lòd
surtout	dàŋ1
taquiner	bàgì
terminer	mànà
tirefort	jəǵ
tomber	kúdî
trouver	swàm
tuyau	ŋ̀-kɔŋ́
vantard	məm̀
vent	ì-vúŋlâ
vessie	ǹ-təǵ
vestige	ì-líg
vociférer	bám
volume	ɛ-̀bím
Yaoundé	ŋgólô
accepter	məm̀
accord	m-ágnì
acerbe	bì-ŋgád
agréable	yɛńî
aile	m̀-pùbnì
amande	m̀-mǎŋ2
appareil	jəǵ
wóódè	ù-tìlgà
arbuste	pàŋnâ
arbuste	ɛ-̀bò
arrière	páglá
asseoir	bógbô
attacher	lád2
bassin	ɛ-̀tám
becqueter	sɔǵ
blesser	kpɛl̀ì
bouder	mə-̀bún
briser	bəǵnì
bétadine	ndwân
cacaoyer	kək̀á
changer	cɛńî2
chez-soi	mbóg
chétif	ŋ̀-kód
cocotier	mbòní
comprendre	wóg
constater	yɛń
convoquer	kùd
co-épouse	mbán
coucher	búdbâ
coupé	ì-cícîgà
courbé	kúꜜkúlá
couteau	ù-kəŋ̀
couvrir	búdbâ
crampe	kúlkádá
décanter	jínbâ
décharger	sùzà
découvrir	swàm
défaite	ì-bɔb̀
dégouliner	sáb
déménager	bólî
dépeçage	ì-bà1
droite	mə-̀jóm
détendre	józê
déterminé	yág
dynamique	jàŋ
emprunter	kòlì
enruler	vùdnì
extraire	pàzì
fatiguer	təg̀
flotter	ndàmdà
fracture	búgî
frapper	bòmlò
frapper	bòmlò
pàŋnâ	ù-tìlgà
pàŋnâ	sàbsábá
funèbre	sádkâ
gonflé	ndàmdà
gueule	m̀-móm
hernie	ì-ndàg
héritage	ì-líg
huissier	lɔýâ
humilier	sámlâ
interdit	bíná
journal	ǹ-nəb́
jugement	jwáz1
lamelle	kpádá
lettre	kálâdà
léger	vɛz̀bàn
magie	ɛ-̀ŋgàŋ
marteler	bòmlò
mauvais	bəb́2
mfumbua	ù-kɔg̀
molesse	à-təǧ
monticule	kòn
mépriser	səŋ́
mystique	à-lú1
oignon	ɛ-̀jǎŋ2
papier	kálâdà
arpillé	càmnì
perplexe	nìgá
pivoter	cìŋlàn
pénitence	túg
prison	ù-pɛd̀
produire	ság2
professer	məm̀
projet	ɲ̀-ɲìní
promener	wùlà
public	ɲ̀-cəŋ̀
rapidité	à-vól
remettre	lɛd̀
remplir	jázlâ
respect	ù-lùgá
retrouver	swàm
répandre	wùlà
rétablir	lɛd̀
sauter	nəm̀nà
schéma	ǹ-nímŋì
s’enivrer	sɔǵ
sexuels	ì-bóŋ
soigner	yáŋnì
souffrir	kwàn
s’étonner	kám2
supplier	lɔ1́
tabac	ɲ̀-cwàn
symbole	ndəm̀1
oile	ù-tə́tɛd̂
tontine	ǹjàŋá
toujours	kwám
tour	pəŋ̀lànà
tourner	cìŋlàn
travailler	sá2
traverser	dàŋ2
tresse	m̀-pɛǹ
tronc	mìŋ-kùg
veiller	bàglà
village	ǹ-nàm
village	à-tán
vrille	ŋ̀-kwǎl
affaiblir	cəg̀2
affaiblir	təg̀
Allemand	njâmnì
ancêtre	m̀-mònì
annoncer	tɔŋ́2
annoncer	yɛńî
apparent	yɛńî
wóódè	ì-zə́záŋ
aérophone	tɔŋ́1
attention	kálâ
avoir	g͡bɛĺə̂1
blesser	kpɛl̀ì
cabochard	ndɔǵ
cacaoyère	kək̀á
cadenas	ɛ-̀ŋgòŋ
causerie	ǹ-náŋ1
combler	dìbgànà
comprimé	ì-bòmó
confiance	pìdì
construire	lóŋ
découpage	ì-bà1
descendre	sùzà
délirer	ləm̀zàn
dormir	ləm̀zàn
dépêcher	à-vól
effectuer	kɔm̀2
déverser	lógzô
Egypte	ìgíptɛǹ
enduit	pídgân2
enlacer	kábdân
ennemi	ǹ-zínzíŋ
enraciner	lád2
espoir	ɲ̀-ɲìní
facile	vɛz̀bàn
faillite	swád2
fente	ǹ-sàlní1
fourmis	kòkómô
glissade	ù-sɛň
grandeur	ŋ̀-kóŋ
yptien	ìgíptɛǹ
initiation	mbón
libido	ŋmg͡bɛz̀
médicament	byàŋ
erveiller	kám2
monnaie	cɛńî1
musodo	ì-zəźáŋ
ombrage	ù-jíjîn
orifice	m̀-mɔǵ
arpiller	càmnì
piment	úndúndúá
plantain	ì-kwàn
pleurnicher	jón
pointe	ɲ̀-cɔŋ̀1
promenade	d-ùlà
providence	mbàm
prétendre	məm̀
réconcilier	kòm
récupérer	twágî
ressort	ɲ̀-càg2
robinet	ŋ̀-kɔŋ́
répandre	càmnì
réprimander	bám
s’agiter	ləǵnì
sculpture	ì-bà1
semence	mə-̀jóm
serrure	ɛ-̀ŋgòŋ
signifier	tììnì
somnoler	ndəŋ̀2
soupir	m̀-vòzbò
suspect	kúꜜkúlá
téméraire	à-tód
timide	ù-sùsùdà
trichome	ɛ-̀vùl
trompette	tɔŋ́1
volonté	ɲ̀-ɲìní
accroupir	sónbô
accumuler	kwàd2
agacement	nìgíz
Allemagne	njâmnì
anglais	íꜜŋgrízí
ankylose	kúlkádá
attarder	ndəŋ̀2
audience	ɲ̀-cəŋ̀
avant-hier	úꜜján
baratin	dɔḱtɛn̂
barrière	ù-pɛd̀
bavard	ù-láŋdânà
cacaotière	kək̀á
calebasse	ndəǵ
cancan	ndəńdɔ́ŋ
caoutchouc	ndàmà
claquement	kpádá
colatier	ɛ-̀bɛľ
compléter	jázlâ
concerter	sónbô
congénère	ù-kàlà
coquille	ì-kòglò
corossol	sàbsábá
costaud	kábdân
cotisation	ǹjàŋá
coussinet	ɛ-̀bâg
crochet	m̀-pɛǹ
diaphragme	ndàm2
disparaître	sêy
disperser	càmnì
désordre	ì-zàmzà
effort	ɛ-̀ndəŋ́
enduire	pídgân2
enrouler	díŋzàn
enrouler	díŋzàn
entretien	ǹ-náŋ1
erimado	ì-zə́záŋ
errance	ɛ-̀ndəŋ́
faillite	m̀-məg̀
flasque	jɔg̀làn
fonctionner	wùlà
fétiche	ɛ-̀ŋgàŋ
grossièretés	lǒm
haineux	ǹ-zínzíŋ
histoire	ǹ-náŋ1
inscrire	tìlbàn
insuccès	m̀-məg̀
Italie	ìtályɛǹ1
jonction	ì-làdgà
maquillage	bázâ
moquer	səg̀lə̀
njangsa	ì-zə́záŋ
nourriture	ɛ-̀dí
palabre	ì-jə́gî
plaisanter	lɔb́1
luchures	ì-kòglò
pressoir	ù-pɛd̀
raccommoder	lɔ2́
rancunier	vùdnì
rapidement	à-vól
reconnaître	jəm̀
refroidir	vwábî
répartition	ŋgàb
résister	kábdân
réussir	kàmzànà
sculpture	à-byà
support	ì-súùgà
surveiller	bàglà
traduire	tìmzànà
trousseau	ɛ-̀sàŋ
vieillard	ɲ̀-ɲǒm
adolescent	ndómní
Amérique	àmɛd̀kán
bagage	m̀-məg̀lə̀
baragouiner	lɔb́1
bien-être	mbwàgí
bougonner	mə-̀bún
camarade	ì-jɔŋ̀2
changement	cɛńî1
charpente	ǹ-nímŋì
communauté	ɛ-̀jóm
compagnie	ì-jɔŋ̀2
compagnon	ì-jɔŋ̀2
confiance	ɛ-̀pìdí
copuler	g͡bɛɛ̀̀nì
cruel	ŋ̀-gə́ŋgɛd́
devoir	g͡bɛĺə̂1
distribution	ŋgàb
djansang	ì-zə́záŋ
désaccord	m̀-pɛď
enflure	ì-pəṕâmà
esprit	ɲ̀-cíꜜɲcím
hypocrisie	ù-ləb̀
ingérer	g͡bàŋbàn
inguinale	ì-ndàg
insulter	səə̀ǹì
internat	ì-pwàgɔ́
intuition	ɲ̀-cwàn
joyeusetés	ì-zàmì
loquace	ù-láŋdânà
maussade	ù-sùsùdà
météore	ù-tə́tɛd̂
munitions	ɛ-̀kɔŋ̌
naissance	ɛ-̀wálî
njansang	ì-zə́záŋ
protester	pɛd̀nì2
réchauffer	jóŋlô
récompense	m-ágnì
recueillir	ləŋ̀1
renchérir	kàmzànà
rencontrer	tóbnì
renfermé	ù-sùsùdà
rivaliser	pɛd̀nì2
sissongo	mì-sɔ̀ŋ
sissongo	mì-sɔ̀ŋ
sortant	ì-pəṕâmà
strophantus	ì-nèy
survivre	vəə̀b̀ə̀
téléphone	ŋ̀-kwǎl
transpercer	tûbnì
acariâtre	bì-ŋgád
acquiesser	kàmzànà
actuellement	à-lú1
américain	àmɛd̀kán
après-demain	úꜜján
attention	səb̀lə̀
battement	m̀-pùbnì
bienveillance	mbàm
bredouiller	búblân
célébration	ù-lùgá
commenter	pɛz̀lànà
contretemps	tûbnì
crépuscule	ù-jíjîn
débrouiller	ndəŋ́
discussion	m̀-pɛď
enfoncer	g͡bàŋbàn
essessang	ì-zə́záŋ
expliquer	tìmzànà
insuffisant	swád2
intervenir	hámzân
italiens	ìtályɛǹ1
mâchoire	ŋm̀-kpəḿ
nouveau	ŋm̀-kpámgí
pennisetum	ǹ-nɔ̌ŋ
pêle-mêle	ì-cícîgà
posséder	g͡bɛĺə̂1
recevoir	g͡bɛɛ̀̀nì
recommander	kùmdà
rendez-vous	m-ágnì
renfrogné	ù-sùsùdà
réveiller	bùmgàn
s’accrocher	hámzân
sélectionner	twáb
s’émerveiller	kám2
souhaitable	sílâ2
stationnement	bán1
Tekaponera	kòkómô
testicule	m̀-mǎŋ2
transmettre	kàlnì
tressaillir	bùmgàn
vandalisme	ɛ-̀tóm1
utilisé	g͡bɛɛ̀ǹì
verbiage	ù-láŋdânà
volubile	ù-láŋdânà
xylophone	ù-mbəǵ
amorce	mə-̀səb̀lə̀
cancanier	ndəńdɔ́ŋ
corossolier	sàbsábá
cérémonie	ì-kááŋgà
désobéissance	ndɔǵ
expliciter	pɛz̀lànà
expliquer	pɛz̀lànà
franchement	kwàgdɔ̀
furoncle	ì-pəṕâmà
mandibule	ŋm̀-kpəḿ
nouveauté	ì-pəṕâmà
opposition	pɛd̀nì2
outrepasser	nəm̀nà
parcimonie	mə-̀zɔý
protestant	àmɛd̀kán
reconnaissant	kàŋ2
squelettique	ŋ̀-kód
traduction	ndìmzàná
accueillir	g͡bɛɛ̀̀nì
admiration	mə-̀kómgó
bouderies	bì-zəg̀dí
concurrencer	pɛd̀nì2
interpréter	pɛz̀lànà
introduire	g͡bàŋbàn
prédateur	g͡bɛɛ̀ǹì
respiration	m̀-vòzbò
sorcellerie	ŋmg͡bɛĺ
vagabondage	ɛ-̀ndə́ŋ
broussailles	ɛ-̀tùmá
clabauderie	ndəńdɔ́ŋ
passifloracée	kòkómô
revendication	ì-zàmì
rigoureux	ŋ̀-gə́ŋgɛd́
silhouette	ɲ̀-cíꜜɲcím
euphorbiacée	ì-zəźáŋ
sifflotement	ù-lə́lɔŋ́
signification	ndìmzàná
subrepticement	kúꜜkúlá
accompagnement	ù-mbəǵ
félicitations	mə-̀tàmná
plaisanterie	bì-zəg̀dí
prostitution	ŋ̀-kànəŋ̀1
sucré	ì-ŋmg͡bəŋ̀mgb͡əg̀
basá	sí
plus	pə ̂
aussi	pə ̂
bien	páŋ
main	d-ɔ ̌
se battre	sìŋ
aguicher	kàz èè
at	ì-tə ́
aurore	cə ́
rougir	və ̀
noir	vín
visite	cə ́
huer	sòg èè
bien	təb́ə ̂
couper	sàl
défi	pɛǹə ̀
durée	ǹ-tə ́
injurier	sə ̀
insulter	sə ̀
litige	ɛ-̀vɔ ́
laver	wɔǵɔ ̂
limite	ɲ̀-ɲə ̀
maïs	sà mbàz
hauteur	ǹ-tə ́
espoir	kâm bə
même si	tɔ
mûrir	və ̀
dessous	á sí
doux	bùd bùd
bonheur	 ́ mbɔm̌
oreille	à-lɔ ́
pluie	fine pòb
proche	bəb̀ə ̀
engendrer	wɔ ́
fil de fer	ŋgáz
montrer	lɛd́ə ̂
oindre	wɔǵɔ ̂
mets	lɔm̀ɔ ̀
bas	wɔ	́
lieu	pə ́
pan	à-lɔ ́
planter	bə	̀
accoucher	wɔ ́
affaire	ɛ-̀vɔ ́
amusersəb̀lə	̀
conflit	ɛ-̀vɔ ́
paume	d-ɔ ́íꜜtə
rester	təm̀ə ́
suspecter	kpə ́
enclos	ì-pwàgɔ ́
pavillon	à-lɔ ́
iroko	ù-sə ́ábâŋ
plante	àlɔ ́mbúâ
plein	ɲɔd̀ɔ ́èè
saturé	ɲɔd̀ɔ ́èè
lèvre	à-lɔ ́ꜜmbɛĺ
solitaire	kɛd́gə ́ítámá
collectivement	lɔb́ɔ ́lɔb́ɔ
rouge	və ̀
défi	pɛǹə ̀
amener	kə ̀èè
mbɛǹbə	̀ mìn
geste	pɛǹə ̀
naïf	zəm̀bə ̀
moment	ɲ̀-ɲə ̀
udit	ɲ̀-ɲəm̀ə ̀
bercer	səb̀lə ̀
déclencher	sə ̀
embellir	ɲəb̀ə ̀
gluant	kəŋ̀bə ̀
eillé	vəə̀b̀ə ̀
améliorer	ɲəb̀ə ̀
entraîner	kə ̀èè
frontière	ɲ̀-ɲə ̀
savant	ɲ̀-ɲə̀mə ̀
tamis	ì-sə̀gzə ̀
initié	ɲ̀-ɲə̀mə ̀
charge	m̀-mə̀glə ̀
insomnie	vəə̀b̀ə ̀
poursuivre	kə ̀èè
connaisseur	ɲ̀-ɲə̀mə ̀
blé	ù-və́gə ̂
amocher	bəb́ə ̂
art	kɛd́bə ̂èè
wóódè	ù-kɛ́nə ̂
fragile	kɛĺə ̂
admettre	jəb́lə ̂
hoqueter	səǵbə ̂
présenter	lɛd́ə ̂
sangloter	səǵbə ̂
croustillant	kɛĺə ̂
besoin	yág èè
bras	d-ɔ ̌
ouse de	ŋgá
dès que	ɲìná
lianes	sɔ ̀
eue	ù-kwàd
partir de	tê
plus que	lòd
pâte	ǹ-tùdà
pot	m̀-mɔŋ̀
pubis	mbùm sí
rat	kwé ì sí
rien	á pûpùd
rechauffe	jóŋ
bâton 	ù-vəŋ̀
cacao	kək̀á
charmer	kàz èè
frêle	líg ꜜlíg
guetter	mwán
légère	bùb èè
aimer	dìŋnì èè
semaine	sɔńɔ ̂
se tromper	dəm̀
teigne	mə-̀kɔ
partir tôt	kún1
asthme	ìbəm̀ kɔ
crinière	ù-làn
courtiser	kàz èè
dimanche	sɔńɔ ̂
médecin	dɔb́dɔ ̂
non-mûr	ì-tòdò
plante médicinale	mbúꜜmbwí
respirer avec peine	səǵzân
déféquer	váz
nuque	kwàd cíŋ
autant que	átá
obliger à	nɔd̀ɔ
provenir de	tê
cage	mwàn ípwàgɔ
lutter	ndəŋ́ èè
papier	mbɔb̀ɔ ̀
répondre de	kàd
trouver	yɛń nâ
bouteille	sɔb́
facile à tromper	kpəǵ
jeune personne	ì-náŋgà
graine immature	m̀-mád
désir sexuel	ŋmg͡bɛz̀
courant d'eau	ɲ̀-càbgà
calmer	vwábî
guérir	vwábî
oiseau	ì-kpá í ꜜŋmám
mal de ventre	bì-lɔǵ
parasite	bád ɛẃálî
pou du pubis	ì-lád1
poignet	ì-bwágzí dɔ
paludisme	tíd mə̀cǐ
macabo	àpǔm ɛb̂àŋà
lit maternel	j-ɔǧ
faire l'amour	bómnì
à l'improviste	mpám
être couché	bəḿə
pomme d'Adam	ù-dág
évaporer	vəb́ə
oiseau	ùnwàn kág
leurs	àbní
leur	àbní
fatigué	ìvɔ ̀ìvɔ
critiquer	sòg èè
dégager	odeur nùm
plantain	ì-lǎd
réussir à	kàbà á
robe	kàbà ŋ̀kùg
serpent	ŋ̀-kág
sœur	mwǎn ꜜmáŋá
tenace	jɔǵbɔ ̂
etui à flèches	pàd
besoin	yág èè
foyer	ndá ɛb̀á
coucher avec	kə2̀
confondre à	pòònò
bouche béé	pòdbò
clopiner	pɛńgə
déranger	jóŋlô
fraîcheur	ì-sín
inutilité	pídí pɔ
graine	ɲ̀-cɔ
glisser	tɛl̀
obstiné à	lɛ̀d ńnó
coup de pied	ɲ̀-càŋ2
faire bouillir	twàgdɔ
pectoraux	ɛ-̀bé ɛ ́tó
personne jeune	ì-náŋgà
banane douce	újô
chaire	ì-kàd màm
bon à rien	zəz̀è
payer dot	vəg̀
supporter	mìn
faire du bruit	dùŋ
agressif	hàm
mettre bas	wɔ ́
nuage	ì-báz í yó
par exprès	ù-váŋ
plantain	ndwán
petit	ǹ-tɔ́gɔ ̂
porte	m̀-mə́ ndá
reste	ì-súg ꜜmɔ
musique	ì-kùd àwú
maternel	ɲà ndómô
poutre	ù-bóŋ ɲádâ
chambre	ì-tùn í ndá
vraiment	kwàgdɔ ̀
faire beaucoup	dàŋ1
canon du fusil	ŋ̀-kɔŋ́ ŋgál
escargot de rivière	ɛ-̀lɔŋ̌
tenir raidement debout	límâ
p pain	bɛɛ̀d̀í
né məm̀àn	àwó
insomnie	tàná
prier	kòglàn èè
adjoint du chef	ì-hɛ́dmàn
palais	ndá ànùŋ
hôpital	dɔb́dɔ ̂
mineur	ǹ-tɔ́gɔ ̂
oboto	àbɔl̀ zwàg
junior	ǹ-tɔ́gɔ ̂
sanglier	ŋgwě ìpə
gandoura	gàŋ dùdà
se briser	bəǵnì
se répandre	wùlà
se réserver	kùgbà
se promener	wùlà
parole	ŋ̀-kɔĺɔ ̂
pendant	kəb̀ kə̀b
infirmier	dɔb́dɔ ̂
locuste	mbàg sàná
extorquer	díínì èè
taille remarquable	pɔɔ̀ḿ
oncle maternel	ɲɔ ̀ ndómô
jeudi	swánɔ ̂məl̀ú mə ́ lá
tomber accidentellement	g͡bàŋbàn
ménage	ndá ɛb̀á
appui	ì-súùgà
flatterie	mbòl
frère	mɔ ̌ꜜtádá
noir foncé	vyùúg
coude	ì-súd bɔŋ́
s'habiller de	dál
iris	ù-ɲǎŋ ꜜdíz
entrée	m̀-mə́ ndá
faible	ndɛd̀gí
pipe	mbə ́ì tàgà
créateur	ŋ̀-kòmò
plus ou moins	ndúŋ
faire sécher	kódô2
pantalon usé	kùlbá2
plat de maïs	ì-kòmò
manquer de peu	pàmzà
oiseau	ŋ́kəĝ məb̀ò
Panthera pardus	zěy
histoire drôle	ì-làŋ
maïs	m-ìz mə ́sádyâ
pique-bœuf	ùnwàn kág
wóódè	mbòŋglí
sévère	jɔǵbɔ ̂
bourgeon	lɔm̀ɔ ̀
se dépêcher	à-vól
embryon	kəm̀ mə̀cǐ
intense	bəg̀ bəg̀
rail	ŋ̀-kɔŋ́ ɲcínâ
oiseau	kwàwɔ́dɔ ̂
poisson fumé	gèdè
silence	ì-kù ndìm
bout du sein	ɲ̀-cɔ̀ŋ ɛb́é
culte eucharistique	mɛź
pomme de terre	mə-̀tódó
tourner autour	cìŋlàn
plante	lélê ǹtáŋní
travail	forcé njɔǵ
travers	kəń ꜜgáná
saison sèche	ì-səb̀
se retenir	kùgbà
racler	wɔḿlɔ ̂
non-sens	pídí pɔ
nez	ù-tə̌m ꜜdóy
leader	àsú zɔg̀ɔ
prune	àpùmá àsá
agacer	pɔŋ́zɔ
bruyant	tòg èè
fatiguer	təg̀ èè
homélie	ì-kàd màm
moindre	ǹ-tɔ́gɔ ̂
sans ailes	ǹ-nəŋ́
iphyte	bád ɛ́wálî
mutondo	ndàm ìbùm
chef	m-òd àtán
mal agir	bəb́ə ̂
frôler	wɔḿlɔ ̂
brute	m̀pím ŋgûdà
chétif	ǹ-tɔ́gɔ ̂
lisse	ŋkwàn ŋkwàn
se tordre	nɔg̀làn
selles	bɔ ̀kògló
avec hâte	mbògmbòg
bas du dos	ɛ-̀tám
inciter à	sòŋlò
aiguille 	ndùndɔ ̀
comte rendu	ndɔŋ́
cinq francs	d-ɔĺɔ
alouette	kwàwɔ́dɔ ̂
adapter	jəm̀zàn èè
accorder	tóbnì èè
vin	kpək̀pàzà njì
rein	m̀-màŋ ɛt́ám
combatif	kàdà kádá
dents agacés	nìgíz
dot forcée	m̀-pəŋ̀ə
fleur	m̀-mɔ̀ŋ lɛń
fer à repasser	áɲân
rencontrer	tóbnò èè
serpent	ù-bóg mbòn
classe d'âge	ù-kàlà
dard	ɲ̀-cɔŋ̀ ḿbómbôŋ
déjeuner	ì-càm ɛk̀àg
plante	ì-tòŋ ɛṕàn
injection	ùndùndɔ ̀
Herpestes	naso mbǎg
beau-père	ɲ̀-cǐ à pâm
caillot de sang	kəm̀ə
civette	ì-sìz ì zɔỳ
faire attention	kálâ
baliverne	pídí pɔ
chef né	àsú zɔg̀ɔ
considérer	yɛń nâ
conspuer	ɲùmnì èè
criquet	mbàg sàná
débutant	ǹ-tɔ́gɔ ̂
piment	ńtɔŋ́ zûdà
plante	ɲádâ ìlwág
pou de la tête	ɲǐn
redouter	ɲàmnì èè
se dérober	sɛl̀gàn
happer	sɔd́ə́ŋgán
infirmière	dɔb́dɔ ̂
